2015-11-16;         47;Alcatel                                           ;Smarthphones y Masivos;               79;           0;                 0;               0;          79;S.C.                ;S.C.                ;           0;           0;          1;Terminales                                        ;ALC 1030                                          
2015-11-16;         47;Alcatel                                           ;Smarthphones y Masivos;             8339;           0;                 0;               0;        8339;0,0                 ;2779,7              ;           3;           3;          1;Terminales                                        ;ALC 1035                                          
2015-11-16;         47;Alcatel                                           ;Smarthphones y Masivos;                1;           0;                 0;               0;           1;S.C.                ;S.C.                ;           0;           0;          1;Terminales                                        ;ALC 1045                                          
2015-11-16;         47;Alcatel                                           ;Smarthphones y Masivos;            34347;           0;                 0;               0;       34347;S.C.                ;S.C.                ;           0;           0;          1;Terminales                                        ;ALC 1052                                          
2015-11-16;         47;Alcatel                                           ;Smarthphones y Masivos;               63;           0;                 0;               0;          63;S.C.                ;S.C.                ;           0;           0;          1;Terminales                                        ;ALC 3041                                          
2015-11-16;         47;Alcatel                                           ;Smarthphones y Masivos;                0;           2;                 1;               3;           3;S.C.                ;S.C.                ;           0;           0;          1;Terminales                                        ;ALC 918                                           
2015-11-16;         47;Alcatel                                           ;Smarthphones y Masivos;                0;           3;                 0;               3;           3;S.C.                ;S.C.                ;           0;           0;          1;Terminales                                        ;ALC 990                                           
2015-11-16;         47;Alcatel                                           ;Smarthphones y Masivos;               96;         397;                 1;             398;         494;199,0               ;247,0               ;           2;           2;          1;Terminales                                        ;ALC Idol 2 mini S                                 
2015-11-16;         47;Alcatel                                           ;Smarthphones y Masivos;              397;        1145;                53;            1198;        1595;52,1                ;69,3                ;          23;          23;          1;Terminales                                        ;ALC Idol 3 4,7                                    
2015-11-16;         47;Alcatel                                           ;Smarthphones y Masivos;                1;           0;                 0;               0;           1;S.C.                ;S.C.                ;           0;           0;          1;Terminales                                        ;ALC Idol X                                        
2015-11-16;         47;Alcatel                                           ;Smarthphones y Masivos;            17232;           1;                 0;               1;       17233;S.C.                ;S.C.                ;           0;           0;          1;Terminales                                        ;ALC Pixi 3 3,5                                    
2015-11-16;         47;Alcatel                                           ;Smarthphones y Masivos;             1223;        2658;                10;            2668;        3891;23,0                ;33,5                ;         116;         116;          1;Terminales                                        ;ALC Pixi 3 4,0                                    
2015-11-16;         47;Alcatel                                           ;Smarthphones y Masivos;                8;         134;                 0;             134;         142;S.C.                ;S.C.                ;           0;           0;          1;Terminales                                        ;ALC Pixi 4007                                     
2015-11-16;         47;Alcatel                                           ;Smarthphones y Masivos;            21892;           0;                 0;               0;       21892;0,0                 ;21892,0             ;           1;           1;          1;Terminales                                        ;ALC POP 3 5,0                                     
2015-11-16;         47;Alcatel                                           ;Smarthphones y Masivos;              340;         225;                 1;             226;         566;226,0               ;566,0               ;           1;           1;          1;Terminales                                        ;ALC POP D1                                        
2015-11-16;         47;Alcatel                                           ;Smarthphones y Masivos;               28;           5;                 0;               5;          33;S.C.                ;S.C.                ;           0;           0;          1;Terminales                                        ;ALC T Pop                                         
2015-11-17;         47;Alcatel                                           ;Smarthphones y Masivos;               79;           0;                 0;               0;          79;S.C.                ;S.C.                ;           0;           0;          2;Terminales                                        ;ALC 1030                                          
2015-11-17;         47;Alcatel                                           ;Smarthphones y Masivos;             6180;           0;                 0;               0;        6180;0,0                 ;4120,0              ;           0;           3;          2;Terminales                                        ;ALC 1035                                          
2015-11-17;         47;Alcatel                                           ;Smarthphones y Masivos;                1;           0;                 0;               0;           1;S.C.                ;S.C.                ;           0;           0;          2;Terminales                                        ;ALC 1045                                          
2015-11-17;         47;Alcatel                                           ;Smarthphones y Masivos;            32773;           0;                 0;               0;       32773;S.C.                ;S.C.                ;           0;           0;          2;Terminales                                        ;ALC 1052                                          
2015-11-17;         47;Alcatel                                           ;Smarthphones y Masivos;               63;           0;                 0;               0;          63;S.C.                ;S.C.                ;           0;           0;          2;Terminales                                        ;ALC 3041                                          
2015-11-17;         47;Alcatel                                           ;Smarthphones y Masivos;                0;           2;                 1;               3;           3;S.C.                ;S.C.                ;           0;           0;          2;Terminales                                        ;ALC 918                                           
2015-11-17;         47;Alcatel                                           ;Smarthphones y Masivos;                0;           3;                 0;               3;           3;S.C.                ;S.C.                ;           0;           0;          2;Terminales                                        ;ALC 990                                           
2015-11-17;         47;Alcatel                                           ;Smarthphones y Masivos;               96;         392;                 1;             393;         489;98,3                ;122,3               ;           6;           8;          2;Terminales                                        ;ALC Idol 2 mini S                                 
2015-11-17;         47;Alcatel                                           ;Smarthphones y Masivos;              341;        1142;                82;            1224;        1565;53,2                ;68,0                ;          23;          46;          2;Terminales                                        ;ALC Idol 3 4,7                                    
2015-11-17;         47;Alcatel                                           ;Smarthphones y Masivos;                1;           0;                 0;               0;           1;S.C.                ;S.C.                ;           0;           0;          2;Terminales                                        ;ALC Idol X                                        
2015-11-17;         47;Alcatel                                           ;Smarthphones y Masivos;            17232;           1;                 0;               1;       17233;S.C.                ;S.C.                ;           0;           0;          2;Terminales                                        ;ALC Pixi 3 3,5                                    
2015-11-17;         47;Alcatel                                           ;Smarthphones y Masivos;             1192;        2563;                43;            2606;        3798;22,5                ;32,7                ;         116;         232;          2;Terminales                                        ;ALC Pixi 3 4,0                                    
2015-11-17;         47;Alcatel                                           ;Smarthphones y Masivos;                8;         135;                 0;             135;         143;-270,0              ;-286,0              ;          -1;          -1;          2;Terminales                                        ;ALC Pixi 4007                                     
2015-11-17;         47;Alcatel                                           ;Smarthphones y Masivos;            21892;           0;                 0;               0;       21892;0,0                 ;43784,0             ;           0;           1;          2;Terminales                                        ;ALC POP 3 5,0                                     
2015-11-17;         47;Alcatel                                           ;Smarthphones y Masivos;              340;         213;                 1;             214;         554;428,0               ;1108,0              ;           0;           1;          2;Terminales                                        ;ALC POP D1                                        
2015-11-17;         47;Alcatel                                           ;Smarthphones y Masivos;               28;           5;                 0;               5;          33;S.C.                ;S.C.                ;           0;           0;          2;Terminales                                        ;ALC T Pop                                         
2015-11-18;         47;Alcatel                                           ;Smarthphones y Masivos;               79;           0;                 0;               0;          79;S.C.                ;S.C.                ;           0;           0;          3;Terminales                                        ;ALC 1030                                          
2015-11-18;         47;Alcatel                                           ;Smarthphones y Masivos;             6180;           0;                 0;               0;        6180;0,0                 ;6180,0              ;           0;           3;          3;Terminales                                        ;ALC 1035                                          
2015-11-18;         47;Alcatel                                           ;Smarthphones y Masivos;                1;           0;                 0;               0;           1;S.C.                ;S.C.                ;           0;           0;          3;Terminales                                        ;ALC 1045                                          
2015-11-18;         47;Alcatel                                           ;Smarthphones y Masivos;            31773;           0;                 0;               0;       31773;S.C.                ;S.C.                ;           0;           0;          3;Terminales                                        ;ALC 1052                                          
2015-11-18;         47;Alcatel                                           ;Smarthphones y Masivos;               63;           0;                 0;               0;          63;S.C.                ;S.C.                ;           0;           0;          3;Terminales                                        ;ALC 3041                                          
2015-11-18;         47;Alcatel                                           ;Smarthphones y Masivos;                0;           2;                 1;               3;           3;S.C.                ;S.C.                ;           0;           0;          3;Terminales                                        ;ALC 918                                           
2015-11-18;         47;Alcatel                                           ;Smarthphones y Masivos;                0;           3;                 0;               3;           3;S.C.                ;S.C.                ;           0;           0;          3;Terminales                                        ;ALC 990                                           
2015-11-18;         47;Alcatel                                           ;Smarthphones y Masivos;              102;         391;                 1;             392;         494;117,6               ;148,2               ;           2;          10;          3;Terminales                                        ;ALC Idol 2 mini S                                 
2015-11-18;         47;Alcatel                                           ;Smarthphones y Masivos;              292;        1134;               108;            1242;        1534;51,0                ;63,0                ;          27;          73;          3;Terminales                                        ;ALC Idol 3 4,7                                    
2015-11-18;         47;Alcatel                                           ;Smarthphones y Masivos;                1;           1;                 0;               1;           2;S.C.                ;S.C.                ;           0;           0;          3;Terminales                                        ;ALC Idol X                                        
2015-11-18;         47;Alcatel                                           ;Smarthphones y Masivos;            14084;           1;                 0;               1;       14085;S.C.                ;S.C.                ;           0;           0;          3;Terminales                                        ;ALC Pixi 3 3,5                                    
2015-11-18;         47;Alcatel                                           ;Smarthphones y Masivos;             1197;        2448;                43;            2491;        3688;21,1                ;31,3                ;         122;         354;          3;Terminales                                        ;ALC Pixi 3 4,0                                    
2015-11-18;         47;Alcatel                                           ;Smarthphones y Masivos;                8;         134;                 0;             134;         142;-402,0              ;-426,0              ;           0;          -1;          3;Terminales                                        ;ALC Pixi 4007                                     
2015-11-18;         47;Alcatel                                           ;Smarthphones y Masivos;            21892;           0;                 0;               0;       21892;0,0                 ;65676,0             ;           0;           1;          3;Terminales                                        ;ALC POP 3 5,0                                     
2015-11-18;         47;Alcatel                                           ;Smarthphones y Masivos;              341;         212;                 1;             213;         554;319,5               ;831,0               ;           1;           2;          3;Terminales                                        ;ALC POP D1                                        
2015-11-18;         47;Alcatel                                           ;Smarthphones y Masivos;               28;           5;                 0;               5;          33;S.C.                ;S.C.                ;           0;           0;          3;Terminales                                        ;ALC T Pop                                         
2015-11-19;         47;Alcatel                                           ;Smarthphones y Masivos;               79;           0;                 0;               0;          79;S.C.                ;S.C.                ;           0;           0;          4;Terminales                                        ;ALC 1030                                          
2015-11-19;         47;Alcatel                                           ;Smarthphones y Masivos;             6180;           0;                 0;               0;        6180;0,0                 ;8240,0              ;           0;           3;          4;Terminales                                        ;ALC 1035                                          
2015-11-19;         47;Alcatel                                           ;Smarthphones y Masivos;                1;           0;                 0;               0;           1;S.C.                ;S.C.                ;           0;           0;          4;Terminales                                        ;ALC 1045                                          
2015-11-19;         47;Alcatel                                           ;Smarthphones y Masivos;            31773;           0;                 0;               0;       31773;S.C.                ;S.C.                ;           0;           0;          4;Terminales                                        ;ALC 1052                                          
2015-11-19;         47;Alcatel                                           ;Smarthphones y Masivos;               63;           0;                 0;               0;          63;S.C.                ;S.C.                ;           0;           0;          4;Terminales                                        ;ALC 3041                                          
2015-11-19;         47;Alcatel                                           ;Smarthphones y Masivos;                0;           2;                 1;               3;           3;S.C.                ;S.C.                ;           0;           0;          4;Terminales                                        ;ALC 918                                           
2015-11-19;         47;Alcatel                                           ;Smarthphones y Masivos;                0;           3;                 0;               3;           3;S.C.                ;S.C.                ;           0;           0;          4;Terminales                                        ;ALC 990                                           
2015-11-19;         47;Alcatel                                           ;Smarthphones y Masivos;              102;         387;                 1;             388;         490;129,3               ;163,3               ;           2;          12;          4;Terminales                                        ;ALC Idol 2 mini S                                 
2015-11-19;         47;Alcatel                                           ;Smarthphones y Masivos;              252;        1138;               123;            1261;        1513;54,8                ;65,8                ;          19;          92;          4;Terminales                                        ;ALC Idol 3 4,7                                    
2015-11-19;         47;Alcatel                                           ;Smarthphones y Masivos;                1;           1;                 0;               1;           2;S.C.                ;S.C.                ;           0;           0;          4;Terminales                                        ;ALC Idol X                                        
2015-11-19;         47;Alcatel                                           ;Smarthphones y Masivos;            14084;           1;                 0;               1;       14085;S.C.                ;S.C.                ;           0;           0;          4;Terminales                                        ;ALC Pixi 3 3,5                                    
2015-11-19;         47;Alcatel                                           ;Smarthphones y Masivos;             1197;        2348;                49;            2397;        3594;21,4                ;32,0                ;          95;         449;          4;Terminales                                        ;ALC Pixi 3 4,0                                    
2015-11-19;         47;Alcatel                                           ;Smarthphones y Masivos;                8;         134;                 0;             134;         142;-536,0              ;-568,0              ;           0;          -1;          4;Terminales                                        ;ALC Pixi 4007                                     
2015-11-19;         47;Alcatel                                           ;Smarthphones y Masivos;            21892;           0;                 0;               0;       21892;0,0                 ;87568,0             ;           0;           1;          4;Terminales                                        ;ALC POP 3 5,0                                     
2015-11-19;         47;Alcatel                                           ;Smarthphones y Masivos;              341;         212;                 1;             213;         554;426,0               ;1108,0              ;           0;           2;          4;Terminales                                        ;ALC POP D1                                        
2015-11-19;         47;Alcatel                                           ;Smarthphones y Masivos;               28;           5;                 0;               5;          33;S.C.                ;S.C.                ;           0;           0;          4;Terminales                                        ;ALC T Pop                                         
2015-11-20;         47;Alcatel                                           ;Smarthphones y Masivos;                0;           0;                 0;               0;           0;0,0                 ;0,0                 ;           6;           9;          5;Terminales                                        ;ALC 1035                                          
2015-11-20;         47;Alcatel                                           ;Smarthphones y Masivos;                0;           0;                 0;               0;           0;0,0                 ;0,0                 ;           3;          15;          5;Terminales                                        ;ALC Idol 2 mini S                                 
2015-11-20;         47;Alcatel                                           ;Smarthphones y Masivos;                0;           0;                 0;               0;           0;0,0                 ;0,0                 ;          24;         116;          5;Terminales                                        ;ALC Idol 3 4,7                                    
2015-11-20;         47;Alcatel                                           ;Smarthphones y Masivos;                0;           0;                 0;               0;           0;0,0                 ;0,0                 ;          77;         526;          5;Terminales                                        ;ALC Pixi 3 4,0                                    
2015-11-20;         47;Alcatel                                           ;Smarthphones y Masivos;                0;           0;                 0;               0;           0;0,0                 ;0,0                 ;           0;          -1;          5;Terminales                                        ;ALC Pixi 4007                                     
2015-11-20;         47;Alcatel                                           ;Smarthphones y Masivos;                0;           0;                 0;               0;           0;0,0                 ;0,0                 ;           0;           1;          5;Terminales                                        ;ALC POP 3 5,0                                     
2015-11-20;         47;Alcatel                                           ;Smarthphones y Masivos;                0;           0;                 0;               0;           0;0,0                 ;0,0                 ;           0;           2;          5;Terminales                                        ;ALC POP D1                                        
2015-11-21;         47;Alcatel                                           ;Smarthphones y Masivos;                0;           0;                 0;               0;           0;0,0                 ;0,0                 ;           0;           9;          6;Terminales                                        ;ALC 1035                                          
2015-11-21;         47;Alcatel                                           ;Smarthphones y Masivos;                0;           0;                 0;               0;           0;0,0                 ;0,0                 ;           2;          17;          6;Terminales                                        ;ALC Idol 2 mini S                                 
2015-11-21;         47;Alcatel                                           ;Smarthphones y Masivos;                0;           0;                 0;               0;           0;0,0                 ;0,0                 ;           1;         117;          6;Terminales                                        ;ALC Idol 3 4,7                                    
2015-11-21;         47;Alcatel                                           ;Smarthphones y Masivos;                0;           0;                 0;               0;           0;0,0                 ;0,0                 ;          25;         551;          6;Terminales                                        ;ALC Pixi 3 4,0                                    
2015-11-21;         47;Alcatel                                           ;Smarthphones y Masivos;                0;           0;                 0;               0;           0;0,0                 ;0,0                 ;           0;          -1;          6;Terminales                                        ;ALC Pixi 4007                                     
2015-11-21;         47;Alcatel                                           ;Smarthphones y Masivos;                0;           0;                 0;               0;           0;0,0                 ;0,0                 ;           0;           1;          6;Terminales                                        ;ALC POP 3 5,0                                     
2015-11-21;         47;Alcatel                                           ;Smarthphones y Masivos;                0;           0;                 0;               0;           0;0,0                 ;0,0                 ;           0;           2;          6;Terminales                                        ;ALC POP D1                                        
2015-11-22;         47;Alcatel                                           ;Smarthphones y Masivos;               79;           0;                 0;               0;          79;S.C.                ;S.C.                ;           0;           0;          7;Terminales                                        ;ALC 1030                                          
2015-11-22;         47;Alcatel                                           ;Smarthphones y Masivos;             6180;           0;                 0;               0;        6180;0,0                 ;4806,7              ;           0;           9;          7;Terminales                                        ;ALC 1035                                          
2015-11-22;         47;Alcatel                                           ;Smarthphones y Masivos;                1;           0;                 0;               0;           1;S.C.                ;S.C.                ;           0;           0;          7;Terminales                                        ;ALC 1045                                          
2015-11-22;         47;Alcatel                                           ;Smarthphones y Masivos;            31199;           0;                 0;               0;       31199;S.C.                ;S.C.                ;           0;           0;          7;Terminales                                        ;ALC 1052                                          
2015-11-22;         47;Alcatel                                           ;Smarthphones y Masivos;               63;           0;                 0;               0;          63;S.C.                ;S.C.                ;           0;           0;          7;Terminales                                        ;ALC 3041                                          
2015-11-22;         47;Alcatel                                           ;Smarthphones y Masivos;                0;           2;                 1;               3;           3;S.C.                ;S.C.                ;           0;           0;          7;Terminales                                        ;ALC 918                                           
2015-11-22;         47;Alcatel                                           ;Smarthphones y Masivos;                0;           3;                 0;               3;           3;S.C.                ;S.C.                ;           0;           0;          7;Terminales                                        ;ALC 990                                           
2015-11-22;         47;Alcatel                                           ;Smarthphones y Masivos;              102;         384;                 1;             385;         487;158,5               ;200,5               ;           0;          17;          7;Terminales                                        ;ALC Idol 2 mini S                                 
2015-11-22;         47;Alcatel                                           ;Smarthphones y Masivos;              244;        1160;                79;            1239;        1483;74,1                ;88,7                ;           0;         117;          7;Terminales                                        ;ALC Idol 3 4,7                                    
2015-11-22;         47;Alcatel                                           ;Smarthphones y Masivos;                1;           1;                 0;               1;           2;S.C.                ;S.C.                ;           0;           0;          7;Terminales                                        ;ALC Idol X                                        
2015-11-22;         47;Alcatel                                           ;Smarthphones y Masivos;            14084;           1;                 0;               1;       14085;S.C.                ;S.C.                ;           0;           0;          7;Terminales                                        ;ALC Pixi 3 3,5                                    
2015-11-22;         47;Alcatel                                           ;Smarthphones y Masivos;             1197;        2268;                24;            2292;        3489;28,9                ;43,9                ;           5;         556;          7;Terminales                                        ;ALC Pixi 3 4,0                                    
2015-11-22;         47;Alcatel                                           ;Smarthphones y Masivos;                8;         134;                 0;             134;         142;-938,0              ;-994,0              ;           0;          -1;          7;Terminales                                        ;ALC Pixi 4007                                     
2015-11-22;         47;Alcatel                                           ;Smarthphones y Masivos;            21892;           0;                 0;               0;       21892;0,0                 ;153244,0            ;           0;           1;          7;Terminales                                        ;ALC POP 3 5,0                                     
2015-11-22;         47;Alcatel                                           ;Smarthphones y Masivos;              341;         212;                 1;             213;         554;745,5               ;1939,0              ;           0;           2;          7;Terminales                                        ;ALC POP D1                                        
2015-11-22;         47;Alcatel                                           ;Smarthphones y Masivos;               28;           5;                 0;               5;          33;S.C.                ;S.C.                ;           0;           0;          7;Terminales                                        ;ALC T Pop                                         
2015-11-23;         48;Alcatel                                           ;Smarthphones y Masivos;               79;           0;                 0;               0;          79;S.C.                ;S.C.                ;           0;           0;          1;Terminales                                        ;ALC 1030                                          
2015-11-23;         48;Alcatel                                           ;Smarthphones y Masivos;             3894;           0;                 0;               0;        3894;S.C.                ;S.C.                ;           0;           0;          1;Terminales                                        ;ALC 1035                                          
2015-11-23;         48;Alcatel                                           ;Smarthphones y Masivos;                1;           0;                 0;               0;           1;S.C.                ;S.C.                ;           0;           0;          1;Terminales                                        ;ALC 1045                                          
2015-11-23;         48;Alcatel                                           ;Smarthphones y Masivos;            30729;           0;                 0;               0;       30729;S.C.                ;S.C.                ;           0;           0;          1;Terminales                                        ;ALC 1052                                          
2015-11-23;         48;Alcatel                                           ;Smarthphones y Masivos;               63;           0;                 0;               0;          63;S.C.                ;S.C.                ;           0;           0;          1;Terminales                                        ;ALC 3041                                          
2015-11-23;         48;Alcatel                                           ;Smarthphones y Masivos;                0;           2;                 1;               3;           3;S.C.                ;S.C.                ;           0;           0;          1;Terminales                                        ;ALC 918                                           
2015-11-23;         48;Alcatel                                           ;Smarthphones y Masivos;                0;           3;                 0;               3;           3;S.C.                ;S.C.                ;           0;           0;          1;Terminales                                        ;ALC 990                                           
2015-11-23;         48;Alcatel                                           ;Smarthphones y Masivos;              131;         380;                 2;             382;         513;191,0               ;256,5               ;           2;           2;          1;Terminales                                        ;ALC Idol 2 mini S                                 
2015-11-23;         48;Alcatel                                           ;Smarthphones y Masivos;              242;        1144;                76;            1220;        1462;45,2                ;54,1                ;          27;          27;          1;Terminales                                        ;ALC Idol 3 4,7                                    
2015-11-23;         48;Alcatel                                           ;Smarthphones y Masivos;                1;           1;                 0;               1;           2;S.C.                ;S.C.                ;           0;           0;          1;Terminales                                        ;ALC Idol X                                        
2015-11-23;         48;Alcatel                                           ;Smarthphones y Masivos;            14084;           1;                 0;               1;       14085;S.C.                ;S.C.                ;           0;           0;          1;Terminales                                        ;ALC Pixi 3 3,5                                    
2015-11-23;         48;Alcatel                                           ;Smarthphones y Masivos;             1199;        2168;                13;            2181;        3380;18,8                ;29,1                ;         116;         116;          1;Terminales                                        ;ALC Pixi 3 4,0                                    
2015-11-23;         48;Alcatel                                           ;Smarthphones y Masivos;                8;         134;                 0;             134;         142;S.C.                ;S.C.                ;           0;           0;          1;Terminales                                        ;ALC Pixi 4007                                     
2015-11-23;         48;Alcatel                                           ;Smarthphones y Masivos;            20204;           0;                 0;               0;       20204;S.C.                ;S.C.                ;           0;           0;          1;Terminales                                        ;ALC POP 3 5,0                                     
2015-11-23;         48;Alcatel                                           ;Smarthphones y Masivos;              385;         212;                 1;             213;         598;S.C.                ;S.C.                ;           0;           0;          1;Terminales                                        ;ALC POP D1                                        
2015-11-23;         48;Alcatel                                           ;Smarthphones y Masivos;               28;           5;                 0;               5;          33;S.C.                ;S.C.                ;           0;           0;          1;Terminales                                        ;ALC T Pop                                         
2015-11-24;         48;Alcatel                                           ;Smarthphones y Masivos;               79;           0;                 0;               0;          79;S.C.                ;S.C.                ;           0;           0;          2;Terminales                                        ;ALC 1030                                          
2015-11-24;         48;Alcatel                                           ;Smarthphones y Masivos;             3894;           0;                 0;               0;        3894;S.C.                ;S.C.                ;           0;           0;          2;Terminales                                        ;ALC 1035                                          
2015-11-24;         48;Alcatel                                           ;Smarthphones y Masivos;                1;           0;                 0;               0;           1;S.C.                ;S.C.                ;           0;           0;          2;Terminales                                        ;ALC 1045                                          
2015-11-24;         48;Alcatel                                           ;Smarthphones y Masivos;            30729;           0;                 0;               0;       30729;S.C.                ;S.C.                ;           0;           0;          2;Terminales                                        ;ALC 1052                                          
2015-11-24;         48;Alcatel                                           ;Smarthphones y Masivos;               63;           0;                 0;               0;          63;S.C.                ;S.C.                ;           0;           0;          2;Terminales                                        ;ALC 3041                                          
2015-11-24;         48;Alcatel                                           ;Smarthphones y Masivos;                0;           2;                 1;               3;           3;S.C.                ;S.C.                ;           0;           0;          2;Terminales                                        ;ALC 918                                           
2015-11-24;         48;Alcatel                                           ;Smarthphones y Masivos;                0;           3;                 0;               3;           3;S.C.                ;S.C.                ;           0;           0;          2;Terminales                                        ;ALC 990                                           
2015-11-24;         48;Alcatel                                           ;Smarthphones y Masivos;              131;         376;                 1;             377;         508;188,5               ;254,0               ;           2;           4;          2;Terminales                                        ;ALC Idol 2 mini S                                 
2015-11-24;         48;Alcatel                                           ;Smarthphones y Masivos;              222;        1181;                41;            1222;        1444;56,8                ;67,2                ;          16;          43;          2;Terminales                                        ;ALC Idol 3 4,7                                    
2015-11-24;         48;Alcatel                                           ;Smarthphones y Masivos;                1;           1;                 0;               1;           2;S.C.                ;S.C.                ;           0;           0;          2;Terminales                                        ;ALC Idol X                                        
2015-11-24;         48;Alcatel                                           ;Smarthphones y Masivos;            14084;           1;                 0;               1;       14085;S.C.                ;S.C.                ;           0;           0;          2;Terminales                                        ;ALC Pixi 3 3,5                                    
2015-11-24;         48;Alcatel                                           ;Smarthphones y Masivos;             1199;        2072;                11;            2083;        3282;22,4                ;35,3                ;          70;         186;          2;Terminales                                        ;ALC Pixi 3 4,0                                    
2015-11-24;         48;Alcatel                                           ;Smarthphones y Masivos;                8;         134;                 0;             134;         142;S.C.                ;S.C.                ;           0;           0;          2;Terminales                                        ;ALC Pixi 4007                                     
2015-11-24;         48;Alcatel                                           ;Smarthphones y Masivos;            18484;           0;                 0;               0;       18484;S.C.                ;S.C.                ;           0;           0;          2;Terminales                                        ;ALC POP 3 5,0                                     
2015-11-24;         48;Alcatel                                           ;Smarthphones y Masivos;              385;         215;                 1;             216;         601;432,0               ;1202,0              ;           1;           1;          2;Terminales                                        ;ALC POP D1                                        
2015-11-24;         48;Alcatel                                           ;Smarthphones y Masivos;               28;           5;                 0;               5;          33;S.C.                ;S.C.                ;           0;           0;          2;Terminales                                        ;ALC T Pop                                         
2015-11-25;         48;Alcatel                                           ;Smarthphones y Masivos;               79;           0;                 0;               0;          79;S.C.                ;S.C.                ;           0;           0;          3;Terminales                                        ;ALC 1030                                          
2015-11-25;         48;Alcatel                                           ;Smarthphones y Masivos;              521;           0;                 0;               0;         521;S.C.                ;S.C.                ;           0;           0;          3;Terminales                                        ;ALC 1035                                          
2015-11-25;         48;Alcatel                                           ;Smarthphones y Masivos;                1;           0;                 0;               0;           1;S.C.                ;S.C.                ;           0;           0;          3;Terminales                                        ;ALC 1045                                          
2015-11-25;         48;Alcatel                                           ;Smarthphones y Masivos;            26586;           0;                 0;               0;       26586;S.C.                ;S.C.                ;           0;           0;          3;Terminales                                        ;ALC 1052                                          
2015-11-25;         48;Alcatel                                           ;Smarthphones y Masivos;               63;           0;                 0;               0;          63;S.C.                ;S.C.                ;           0;           0;          3;Terminales                                        ;ALC 3041                                          
2015-11-25;         48;Alcatel                                           ;Smarthphones y Masivos;                0;           3;                 0;               3;           3;S.C.                ;S.C.                ;           0;           0;          3;Terminales                                        ;ALC 918                                           
2015-11-25;         48;Alcatel                                           ;Smarthphones y Masivos;                0;           3;                 0;               3;           3;S.C.                ;S.C.                ;           0;           0;          3;Terminales                                        ;ALC 990                                           
2015-11-25;         48;Alcatel                                           ;Smarthphones y Masivos;              131;         371;                 2;             373;         504;139,9               ;189,0               ;           4;           8;          3;Terminales                                        ;ALC Idol 2 mini S                                 
2015-11-25;         48;Alcatel                                           ;Smarthphones y Masivos;              200;        1184;                43;            1227;        1427;63,5                ;73,8                ;          15;          58;          3;Terminales                                        ;ALC Idol 3 4,7                                    
2015-11-25;         48;Alcatel                                           ;Smarthphones y Masivos;                1;           1;                 0;               1;           2;S.C.                ;S.C.                ;           0;           0;          3;Terminales                                        ;ALC Idol X                                        
2015-11-25;         48;Alcatel                                           ;Smarthphones y Masivos;            13884;           1;                 0;               1;       13885;S.C.                ;S.C.                ;           0;           0;          3;Terminales                                        ;ALC Pixi 3 3,5                                    
2015-11-25;         48;Alcatel                                           ;Smarthphones y Masivos;             1198;        1994;                19;            2013;        3211;23,4                ;37,3                ;          72;         258;          3;Terminales                                        ;ALC Pixi 3 4,0                                    
2015-11-25;         48;Alcatel                                           ;Smarthphones y Masivos;                8;         134;                 0;             134;         142;S.C.                ;S.C.                ;           0;           0;          3;Terminales                                        ;ALC Pixi 4007                                     
2015-11-25;         48;Alcatel                                           ;Smarthphones y Masivos;            18484;           0;                 0;               0;       18484;S.C.                ;S.C.                ;           0;           0;          3;Terminales                                        ;ALC POP 3 5,0                                     
2015-11-25;         48;Alcatel                                           ;Smarthphones y Masivos;              385;         214;                 1;             215;         600;322,5               ;900,0               ;           1;           2;          3;Terminales                                        ;ALC POP D1                                        
2015-11-25;         48;Alcatel                                           ;Smarthphones y Masivos;               28;           5;                 0;               5;          33;S.C.                ;S.C.                ;           0;           0;          3;Terminales                                        ;ALC T Pop                                         
2015-11-26;         48;Alcatel                                           ;Smarthphones y Masivos;               79;           0;                 0;               0;          79;S.C.                ;S.C.                ;           0;           0;          4;Terminales                                        ;ALC 1030                                          
2015-11-26;         48;Alcatel                                           ;Smarthphones y Masivos;              322;           0;                 0;               0;         322;S.C.                ;S.C.                ;           0;           0;          4;Terminales                                        ;ALC 1035                                          
2015-11-26;         48;Alcatel                                           ;Smarthphones y Masivos;                1;           0;                 0;               0;           1;S.C.                ;S.C.                ;           0;           0;          4;Terminales                                        ;ALC 1045                                          
2015-11-26;         48;Alcatel                                           ;Smarthphones y Masivos;            26586;           0;                 0;               0;       26586;S.C.                ;S.C.                ;           0;           0;          4;Terminales                                        ;ALC 1052                                          
2015-11-26;         48;Alcatel                                           ;Smarthphones y Masivos;               63;           0;                 0;               0;          63;S.C.                ;S.C.                ;           0;           0;          4;Terminales                                        ;ALC 3041                                          
2015-11-26;         48;Alcatel                                           ;Smarthphones y Masivos;                0;           3;                 0;               3;           3;S.C.                ;S.C.                ;           0;           0;          4;Terminales                                        ;ALC 918                                           
2015-11-26;         48;Alcatel                                           ;Smarthphones y Masivos;                0;           3;                 0;               3;           3;S.C.                ;S.C.                ;           0;           0;          4;Terminales                                        ;ALC 990                                           
2015-11-26;         48;Alcatel                                           ;Smarthphones y Masivos;              131;         371;                 0;             371;         502;123,7               ;167,3               ;           4;          12;          4;Terminales                                        ;ALC Idol 2 mini S                                 
2015-11-26;         48;Alcatel                                           ;Smarthphones y Masivos;              200;        1188;                17;            1205;        1405;62,6                ;73,0                ;          19;          77;          4;Terminales                                        ;ALC Idol 3 4,7                                    
2015-11-26;         48;Alcatel                                           ;Smarthphones y Masivos;                1;           1;                 0;               1;           2;S.C.                ;S.C.                ;           0;           0;          4;Terminales                                        ;ALC Idol X                                        
2015-11-26;         48;Alcatel                                           ;Smarthphones y Masivos;            13884;           1;                 0;               1;       13885;S.C.                ;S.C.                ;           0;           0;          4;Terminales                                        ;ALC Pixi 3 3,5                                    
2015-11-26;         48;Alcatel                                           ;Smarthphones y Masivos;             1198;        1926;                15;            1941;        3139;23,1                ;37,4                ;          78;         336;          4;Terminales                                        ;ALC Pixi 3 4,0                                    
2015-11-26;         48;Alcatel                                           ;Smarthphones y Masivos;                8;         134;                 0;             134;         142;S.C.                ;S.C.                ;           0;           0;          4;Terminales                                        ;ALC Pixi 4007                                     
2015-11-26;         48;Alcatel                                           ;Smarthphones y Masivos;            18484;           0;                 0;               0;       18484;S.C.                ;S.C.                ;           0;           0;          4;Terminales                                        ;ALC POP 3 5,0                                     
2015-11-26;         48;Alcatel                                           ;Smarthphones y Masivos;              385;         214;                 1;             215;         600;430,0               ;1200,0              ;           0;           2;          4;Terminales                                        ;ALC POP D1                                        
2015-11-26;         48;Alcatel                                           ;Smarthphones y Masivos;               28;           5;                 0;               5;          33;S.C.                ;S.C.                ;           0;           0;          4;Terminales                                        ;ALC T Pop                                         
2015-11-27;         48;Alcatel                                           ;Smarthphones y Masivos;                0;           0;                 0;               0;           0;0,0                 ;0,0                 ;           5;          17;          5;Terminales                                        ;ALC Idol 2 mini S                                 
2015-11-27;         48;Alcatel                                           ;Smarthphones y Masivos;                0;           0;                 0;               0;           0;0,0                 ;0,0                 ;           7;          84;          5;Terminales                                        ;ALC Idol 3 4,7                                    
2015-11-27;         48;Alcatel                                           ;Smarthphones y Masivos;                0;           0;                 0;               0;           0;0,0                 ;0,0                 ;          78;         414;          5;Terminales                                        ;ALC Pixi 3 4,0                                    
2015-11-27;         48;Alcatel                                           ;Smarthphones y Masivos;                0;           0;                 0;               0;           0;0,0                 ;0,0                 ;           2;           4;          5;Terminales                                        ;ALC POP D1                                        
2015-11-28;         48;Alcatel                                           ;Smarthphones y Masivos;                0;           0;                 0;               0;           0;0,0                 ;0,0                 ;           1;          18;          6;Terminales                                        ;ALC Idol 2 mini S                                 
2015-11-28;         48;Alcatel                                           ;Smarthphones y Masivos;                0;           0;                 0;               0;           0;0,0                 ;0,0                 ;           1;          85;          6;Terminales                                        ;ALC Idol 3 4,7                                    
2015-11-28;         48;Alcatel                                           ;Smarthphones y Masivos;                0;           0;                 0;               0;           0;0,0                 ;0,0                 ;          39;         453;          6;Terminales                                        ;ALC Pixi 3 4,0                                    
2015-11-28;         48;Alcatel                                           ;Smarthphones y Masivos;                0;           0;                 0;               0;           0;0,0                 ;0,0                 ;           0;           4;          6;Terminales                                        ;ALC POP D1                                        
2015-11-29;         48;Alcatel                                           ;Smarthphones y Masivos;               79;           0;                 0;               0;          79;S.C.                ;S.C.                ;           0;           0;          7;Terminales                                        ;ALC 1030                                          
2015-11-29;         48;Alcatel                                           ;Smarthphones y Masivos;                7;           0;                 0;               0;           7;0,0                 ;16,3                ;           3;           3;          7;Terminales                                        ;ALC 1035                                          
2015-11-29;         48;Alcatel                                           ;Smarthphones y Masivos;                1;           0;                 0;               0;           1;S.C.                ;S.C.                ;           0;           0;          7;Terminales                                        ;ALC 1045                                          
2015-11-29;         48;Alcatel                                           ;Smarthphones y Masivos;            24951;           0;                 0;               0;       24951;S.C.                ;S.C.                ;           0;           0;          7;Terminales                                        ;ALC 1052                                          
2015-11-29;         48;Alcatel                                           ;Smarthphones y Masivos;               63;           0;                 0;               0;          63;S.C.                ;S.C.                ;           0;           0;          7;Terminales                                        ;ALC 3041                                          
2015-11-29;         48;Alcatel                                           ;Smarthphones y Masivos;                0;           3;                 0;               3;           3;S.C.                ;S.C.                ;           0;           0;          7;Terminales                                        ;ALC 918                                           
2015-11-29;         48;Alcatel                                           ;Smarthphones y Masivos;                0;           3;                 0;               3;           3;S.C.                ;S.C.                ;           0;           0;          7;Terminales                                        ;ALC 990                                           
2015-11-29;         48;Alcatel                                           ;Smarthphones y Masivos;              133;         365;                 0;             365;         498;141,9               ;193,7               ;           0;          18;          7;Terminales                                        ;ALC Idol 2 mini S                                 
2015-11-29;         48;Alcatel                                           ;Smarthphones y Masivos;              182;        1174;                27;            1201;        1383;97,8                ;112,6               ;           1;          86;          7;Terminales                                        ;ALC Idol 3 4,7                                    
2015-11-29;         48;Alcatel                                           ;Smarthphones y Masivos;                1;           1;                 0;               1;           2;S.C.                ;S.C.                ;           0;           0;          7;Terminales                                        ;ALC Idol X                                        
2015-11-29;         48;Alcatel                                           ;Smarthphones y Masivos;            12523;           1;                 0;               1;       12524;S.C.                ;S.C.                ;           0;           0;          7;Terminales                                        ;ALC Pixi 3 3,5                                    
2015-11-29;         48;Alcatel                                           ;Smarthphones y Masivos;             1232;        1789;                22;            1811;        3043;27,2                ;45,7                ;          13;         466;          7;Terminales                                        ;ALC Pixi 3 4,0                                    
2015-11-29;         48;Alcatel                                           ;Smarthphones y Masivos;                8;         134;                 0;             134;         142;S.C.                ;S.C.                ;           0;           0;          7;Terminales                                        ;ALC Pixi 4007                                     
2015-11-29;         48;Alcatel                                           ;Smarthphones y Masivos;            18484;           0;                 0;               0;       18484;S.C.                ;S.C.                ;           0;           0;          7;Terminales                                        ;ALC POP 3 5,0                                     
2015-11-29;         48;Alcatel                                           ;Smarthphones y Masivos;              388;         212;                 1;             213;         601;372,8               ;1051,8              ;           0;           4;          7;Terminales                                        ;ALC POP D1                                        
2015-11-29;         48;Alcatel                                           ;Smarthphones y Masivos;               28;           5;                 0;               5;          33;S.C.                ;S.C.                ;           0;           0;          7;Terminales                                        ;ALC T Pop                                         
2015-11-30;         49;Alcatel                                           ;Smarthphones y Masivos;               79;           0;                 0;               0;          79;S.C.                ;S.C.                ;           0;           0;          1;Terminales                                        ;ALC 1030                                          
2015-11-30;         49;Alcatel                                           ;Smarthphones y Masivos;                7;           0;                 0;               0;           7;S.C.                ;S.C.                ;           0;           0;          1;Terminales                                        ;ALC 1035                                          
2015-11-30;         49;Alcatel                                           ;Smarthphones y Masivos;                1;           0;                 0;               0;           1;S.C.                ;S.C.                ;           0;           0;          1;Terminales                                        ;ALC 1045                                          
2015-11-30;         49;Alcatel                                           ;Smarthphones y Masivos;            23411;           0;                 0;               0;       23411;S.C.                ;S.C.                ;           0;           0;          1;Terminales                                        ;ALC 1052                                          
2015-11-30;         49;Alcatel                                           ;Smarthphones y Masivos;               63;           0;                 0;               0;          63;S.C.                ;S.C.                ;           0;           0;          1;Terminales                                        ;ALC 3041                                          
2015-11-30;         49;Alcatel                                           ;Smarthphones y Masivos;                0;           3;                 0;               3;           3;S.C.                ;S.C.                ;           0;           0;          1;Terminales                                        ;ALC 918                                           
2015-11-30;         49;Alcatel                                           ;Smarthphones y Masivos;                0;           3;                 0;               3;           3;S.C.                ;S.C.                ;           0;           0;          1;Terminales                                        ;ALC 990                                           
2015-11-30;         49;Alcatel                                           ;Smarthphones y Masivos;              133;         343;                 0;             343;         476;171,5               ;238,0               ;           2;           2;          1;Terminales                                        ;ALC Idol 2 mini S                                 
2015-11-30;         49;Alcatel                                           ;Smarthphones y Masivos;              168;        1149;                40;            1189;        1357;49,5                ;56,5                ;          24;          24;          1;Terminales                                        ;ALC Idol 3 4,7                                    
2015-11-30;         49;Alcatel                                           ;Smarthphones y Masivos;                1;           1;                 0;               1;           2;S.C.                ;S.C.                ;           0;           0;          1;Terminales                                        ;ALC Idol X                                        
2015-11-30;         49;Alcatel                                           ;Smarthphones y Masivos;            12523;           1;                 0;               1;       12524;S.C.                ;S.C.                ;           0;           0;          1;Terminales                                        ;ALC Pixi 3 3,5                                    
2015-11-30;         49;Alcatel                                           ;Smarthphones y Masivos;             1232;        1731;                10;            1741;        2973;24,9                ;42,5                ;          70;          70;          1;Terminales                                        ;ALC Pixi 3 4,0                                    
2015-11-30;         49;Alcatel                                           ;Smarthphones y Masivos;                8;         134;                 0;             134;         142;S.C.                ;S.C.                ;           0;           0;          1;Terminales                                        ;ALC Pixi 4007                                     
2015-11-30;         49;Alcatel                                           ;Smarthphones y Masivos;            18484;           0;                 0;               0;       18484;S.C.                ;S.C.                ;           0;           0;          1;Terminales                                        ;ALC POP 3 5,0                                     
2015-11-30;         49;Alcatel                                           ;Smarthphones y Masivos;              388;         183;                 1;             184;         572;S.C.                ;S.C.                ;           0;           0;          1;Terminales                                        ;ALC POP D1                                        
2015-11-30;         49;Alcatel                                           ;Smarthphones y Masivos;               28;           5;                 0;               5;          33;S.C.                ;S.C.                ;           0;           0;          1;Terminales                                        ;ALC T Pop                                         
2015-11-16;         47;Apple                                             ;iPhone y Premium      ;             2127;         613;               132;             745;        2872;24,0                ;92,6                ;          31;          31;          1;Peru                                              ;APP 6 Plus 16GB                                   
2015-11-16;         47;Apple                                             ;iPhone y Premium      ;               62;           0;                 0;               0;          62;S.C.                ;S.C.                ;           0;           0;          1;Terminales                                        ;APP 3GS 32GB                                      
2015-11-16;         47;Apple                                             ;iPhone y Premium      ;              101;           6;                 0;               6;         107;S.C.                ;S.C.                ;           0;           0;          1;Terminales                                        ;APP 3GS 8GB                                       
2015-11-16;         47;Apple                                             ;iPhone y Premium      ;               42;           0;                 0;               0;          42;S.C.                ;S.C.                ;           0;           0;          1;Terminales                                        ;APP 4 16GB                                        
2015-11-16;         47;Apple                                             ;iPhone y Premium      ;                9;           3;                 0;               3;          12;S.C.                ;S.C.                ;           0;           0;          1;Terminales                                        ;APP 4 32GB                                        
2015-11-16;         47;Apple                                             ;iPhone y Premium      ;              177;          48;                 1;              49;         226;S.C.                ;S.C.                ;           0;           0;          1;Terminales                                        ;APP 4 8GB                                         
2015-11-16;         47;Apple                                             ;iPhone y Premium      ;               11;          27;                 4;              31;          42;S.C.                ;S.C.                ;           0;           0;          1;Terminales                                        ;APP 4S 16GB                                       
2015-11-16;         47;Apple                                             ;iPhone y Premium      ;                2;           5;                 0;               5;           7;S.C.                ;S.C.                ;           0;           0;          1;Terminales                                        ;APP 4S 32GB                                       
2015-11-16;         47;Apple                                             ;iPhone y Premium      ;                0;           2;                 0;               2;           2;S.C.                ;S.C.                ;           0;           0;          1;Terminales                                        ;APP 4S 64GB                                       
2015-11-16;         47;Apple                                             ;iPhone y Premium      ;               36;         321;                 6;             327;         363;327,0               ;363,0               ;           1;           1;          1;Terminales                                        ;APP 4S 8GB                                        
2015-11-16;         47;Apple                                             ;iPhone y Premium      ;                4;          10;                 5;              15;          19;S.C.                ;S.C.                ;           0;           0;          1;Terminales                                        ;APP 5 16GB                                        
2015-11-16;         47;Apple                                             ;iPhone y Premium      ;                1;           0;                 1;               1;           2;S.C.                ;S.C.                ;           0;           0;          1;Terminales                                        ;APP 5 64GB                                        
2015-11-16;         47;Apple                                             ;iPhone y Premium      ;               80;          95;                24;             119;         199;S.C.                ;S.C.                ;           0;           0;          1;Terminales                                        ;APP 5C 16GB                                       
2015-11-16;         47;Apple                                             ;iPhone y Premium      ;               68;         410;                13;             423;         491;141,0               ;163,7               ;           3;           3;          1;Terminales                                        ;APP 5C 8GB                                        
2015-11-16;         47;Apple                                             ;iPhone y Premium      ;             2572;        1504;               230;            1734;        4306;3,8                 ;9,4                 ;         456;         456;          1;Terminales                                        ;APP 5S 16GB                                       
2015-11-16;         47;Apple                                             ;iPhone y Premium      ;               38;          66;                 8;              74;         112;S.C.                ;S.C.                ;           0;           0;          1;Terminales                                        ;APP 5S 32GB                                       
2015-11-16;         47;Apple                                             ;iPhone y Premium      ;               14;           5;                 0;               5;          19;S.C.                ;S.C.                ;           0;           0;          1;Terminales                                        ;APP 5S 64GB                                       
2015-11-16;         47;Apple                                             ;iPhone y Premium      ;               18;          64;                 1;              65;          83;65,0                ;83,0                ;           1;           1;          1;Terminales                                        ;APP 6 128GB                                       
2015-11-16;         47;Apple                                             ;iPhone y Premium      ;             4701;        3268;              1887;            5155;        9856;20,6                ;39,4                ;         250;         250;          1;Terminales                                        ;APP 6 16GB                                        
2015-11-16;         47;Apple                                             ;iPhone y Premium      ;               40;         589;                85;             674;         714;23,2                ;24,6                ;          29;          29;          1;Terminales                                        ;APP 6 64GB                                        
2015-11-16;         47;Apple                                             ;iPhone y Premium      ;               27;         264;                10;             274;         301;274,0               ;301,0               ;           1;           1;          1;Terminales                                        ;APP 6 Plus 16GB                                   
2015-11-16;         47;Apple                                             ;iPhone y Premium      ;                3;           8;                 0;               8;          11;S.C.                ;S.C.                ;           0;           0;          1;Terminales                                        ;APP 6 Plus 64GB                                   
2015-11-16;         47;Apple                                             ;iPhone y Premium      ;              240;         167;               139;             306;         546;51,0                ;91,0                ;           6;           6;          1;Terminales                                        ;APP 6S 128GB                                      
2015-11-16;         47;Apple                                             ;iPhone y Premium      ;             7773;        5549;              1333;            6882;       14655;31,6                ;67,2                ;         218;         218;          1;Terminales                                        ;APP 6S 16GB                                       
2015-11-16;         47;Apple                                             ;iPhone y Premium      ;              733;        1525;               255;            1780;        2513;18,2                ;25,6                ;          98;          98;          1;Terminales                                        ;APP 6S 64GB                                       
2015-11-16;         47;Apple                                             ;iPhone y Premium      ;               11;           0;                 0;               0;          11;S.C.                ;S.C.                ;           0;           0;          1;Terminales                                        ;APP 6S DEMO                                       
2015-11-16;         47;Apple                                             ;iPhone y Premium      ;             1052;        1354;               299;            1653;        2705;40,3                ;66,0                ;          41;          41;          1;Terminales                                        ;APP 6S PLUS 16GB                                  
2015-11-16;         47;Apple                                             ;iPhone y Premium      ;              657;         349;               124;             473;        1130;18,2                ;43,5                ;          26;          26;          1;Terminales                                        ;APP 6S PLUS 64GB                                  
2015-11-16;         47;Apple                                             ;iPhone y Premium      ;                6;           0;                 0;               0;           6;S.C.                ;S.C.                ;           0;           0;          1;Terminales                                        ;APP 6S PLUS DEMO                                  
2015-11-16;         47;Apple                                             ;iPhone y Premium      ;                1;           0;                 0;               0;           1;S.C.                ;S.C.                ;           0;           0;          1;Terminales                                        ;Apple Mini 32 GB                                  
2015-11-17;         47;Apple                                             ;iPhone y Premium      ;             2041;         602;               205;             807;        2848;27,8                ;98,2                ;          27;          58;          2;Peru                                              ;APP 6 Plus 16GB                                   
2015-11-17;         47;Apple                                             ;iPhone y Premium      ;               62;           0;                 0;               0;          62;S.C.                ;S.C.                ;           0;           0;          2;Terminales                                        ;APP 3GS 32GB                                      
2015-11-17;         47;Apple                                             ;iPhone y Premium      ;              101;           6;                 0;               6;         107;S.C.                ;S.C.                ;           0;           0;          2;Terminales                                        ;APP 3GS 8GB                                       
2015-11-17;         47;Apple                                             ;iPhone y Premium      ;               42;           0;                 0;               0;          42;S.C.                ;S.C.                ;           0;           0;          2;Terminales                                        ;APP 4 16GB                                        
2015-11-17;         47;Apple                                             ;iPhone y Premium      ;                9;           3;                 0;               3;          12;S.C.                ;S.C.                ;           0;           0;          2;Terminales                                        ;APP 4 32GB                                        
2015-11-17;         47;Apple                                             ;iPhone y Premium      ;              177;          48;                 1;              49;         226;S.C.                ;S.C.                ;           0;           0;          2;Terminales                                        ;APP 4 8GB                                         
2015-11-17;         47;Apple                                             ;iPhone y Premium      ;               11;          27;                 4;              31;          42;S.C.                ;S.C.                ;           0;           0;          2;Terminales                                        ;APP 4S 16GB                                       
2015-11-17;         47;Apple                                             ;iPhone y Premium      ;                2;           5;                 0;               5;           7;S.C.                ;S.C.                ;           0;           0;          2;Terminales                                        ;APP 4S 32GB                                       
2015-11-17;         47;Apple                                             ;iPhone y Premium      ;                0;           2;                 0;               2;           2;S.C.                ;S.C.                ;           0;           0;          2;Terminales                                        ;APP 4S 64GB                                       
2015-11-17;         47;Apple                                             ;iPhone y Premium      ;               36;         321;                 6;             327;         363;327,0               ;363,0               ;           1;           2;          2;Terminales                                        ;APP 4S 8GB                                        
2015-11-17;         47;Apple                                             ;iPhone y Premium      ;                4;          10;                 5;              15;          19;S.C.                ;S.C.                ;           0;           0;          2;Terminales                                        ;APP 5 16GB                                        
2015-11-17;         47;Apple                                             ;iPhone y Premium      ;                1;           0;                 1;               1;           2;S.C.                ;S.C.                ;           0;           0;          2;Terminales                                        ;APP 5 64GB                                        
2015-11-17;         47;Apple                                             ;iPhone y Premium      ;               80;          95;                24;             119;         199;S.C.                ;S.C.                ;           0;           0;          2;Terminales                                        ;APP 5C 16GB                                       
2015-11-17;         47;Apple                                             ;iPhone y Premium      ;               68;         405;                13;             418;         486;69,7                ;81,0                ;           9;          12;          2;Terminales                                        ;APP 5C 8GB                                        
2015-11-17;         47;Apple                                             ;iPhone y Premium      ;              598;        1221;              1896;            3117;        3715;7,8                 ;9,3                 ;         340;         796;          2;Terminales                                        ;APP 5S 16GB                                       
2015-11-17;         47;Apple                                             ;iPhone y Premium      ;               38;          61;                 8;              69;         107;S.C.                ;S.C.                ;           0;           0;          2;Terminales                                        ;APP 5S 32GB                                       
2015-11-17;         47;Apple                                             ;iPhone y Premium      ;               14;           5;                 0;               5;          19;S.C.                ;S.C.                ;           0;           0;          2;Terminales                                        ;APP 5S 64GB                                       
2015-11-17;         47;Apple                                             ;iPhone y Premium      ;               18;          61;                 1;              62;          80;31,0                ;40,0                ;           3;           4;          2;Terminales                                        ;APP 6 128GB                                       
2015-11-17;         47;Apple                                             ;iPhone y Premium      ;             4913;        3359;              1839;            5198;       10111;17,4                ;33,8                ;         348;         598;          2;Terminales                                        ;APP 6 16GB                                        
2015-11-17;         47;Apple                                             ;iPhone y Premium      ;               22;         582;                67;             649;         671;18,3                ;18,9                ;          42;          71;          2;Terminales                                        ;APP 6 64GB                                        
2015-11-17;         47;Apple                                             ;iPhone y Premium      ;               27;         263;                10;             273;         300;182,0               ;200,0               ;           2;           3;          2;Terminales                                        ;APP 6 Plus 16GB                                   
2015-11-17;         47;Apple                                             ;iPhone y Premium      ;                3;           8;                 0;               8;          11;S.C.                ;S.C.                ;           0;           0;          2;Terminales                                        ;APP 6 Plus 64GB                                   
2015-11-17;         47;Apple                                             ;iPhone y Premium      ;              218;         200;               117;             317;         535;37,3                ;62,9                ;          11;          17;          2;Terminales                                        ;APP 6S 128GB                                      
2015-11-17;         47;Apple                                             ;iPhone y Premium      ;             7445;        5909;              1056;            6965;       14410;30,8                ;63,8                ;         234;         452;          2;Terminales                                        ;APP 6S 16GB                                       
2015-11-17;         47;Apple                                             ;iPhone y Premium      ;              480;        1508;               397;            1905;        2385;17,1                ;21,4                ;         125;         223;          2;Terminales                                        ;APP 6S 64GB                                       
2015-11-17;         47;Apple                                             ;iPhone y Premium      ;               11;           0;                 0;               0;          11;S.C.                ;S.C.                ;           0;           0;          2;Terminales                                        ;APP 6S DEMO                                       
2015-11-17;         47;Apple                                             ;iPhone y Premium      ;             1007;        1424;               373;            1797;        2804;49,2                ;76,8                ;          32;          73;          2;Terminales                                        ;APP 6S PLUS 16GB                                  
2015-11-17;         47;Apple                                             ;iPhone y Premium      ;              646;         349;               104;             453;        1099;15,9                ;38,6                ;          31;          57;          2;Terminales                                        ;APP 6S PLUS 64GB                                  
2015-11-17;         47;Apple                                             ;iPhone y Premium      ;                6;           0;                 0;               0;           6;S.C.                ;S.C.                ;           0;           0;          2;Terminales                                        ;APP 6S PLUS DEMO                                  
2015-11-17;         47;Apple                                             ;iPhone y Premium      ;                1;           0;                 0;               0;           1;S.C.                ;S.C.                ;           0;           0;          2;Terminales                                        ;Apple Mini 32 GB                                  
2015-11-18;         47;Apple                                             ;iPhone y Premium      ;             2019;         705;               111;             816;        2835;35,5                ;123,3               ;          11;          69;          3;Peru                                              ;APP 6 Plus 16GB                                   
2015-11-18;         47;Apple                                             ;iPhone y Premium      ;               62;           0;                 0;               0;          62;S.C.                ;S.C.                ;           0;           0;          3;Terminales                                        ;APP 3GS 32GB                                      
2015-11-18;         47;Apple                                             ;iPhone y Premium      ;              101;           6;                 0;               6;         107;S.C.                ;S.C.                ;           0;           0;          3;Terminales                                        ;APP 3GS 8GB                                       
2015-11-18;         47;Apple                                             ;iPhone y Premium      ;               42;           0;                 0;               0;          42;S.C.                ;S.C.                ;           0;           0;          3;Terminales                                        ;APP 4 16GB                                        
2015-11-18;         47;Apple                                             ;iPhone y Premium      ;                9;           3;                 0;               3;          12;S.C.                ;S.C.                ;           0;           0;          3;Terminales                                        ;APP 4 32GB                                        
2015-11-18;         47;Apple                                             ;iPhone y Premium      ;              189;          40;                 1;              41;         230;S.C.                ;S.C.                ;           0;           0;          3;Terminales                                        ;APP 4 8GB                                         
2015-11-18;         47;Apple                                             ;iPhone y Premium      ;               14;          26;                 4;              30;          44;S.C.                ;S.C.                ;           0;           0;          3;Terminales                                        ;APP 4S 16GB                                       
2015-11-18;         47;Apple                                             ;iPhone y Premium      ;                3;           5;                 0;               5;           8;S.C.                ;S.C.                ;           0;           0;          3;Terminales                                        ;APP 4S 32GB                                       
2015-11-18;         47;Apple                                             ;iPhone y Premium      ;                0;           2;                 0;               2;           2;S.C.                ;S.C.                ;           0;           0;          3;Terminales                                        ;APP 4S 64GB                                       
2015-11-18;         47;Apple                                             ;iPhone y Premium      ;               36;         319;                 6;             325;         361;487,5               ;541,5               ;           0;           2;          3;Terminales                                        ;APP 4S 8GB                                        
2015-11-18;         47;Apple                                             ;iPhone y Premium      ;                4;           7;                 5;              12;          16;S.C.                ;S.C.                ;           0;           0;          3;Terminales                                        ;APP 5 16GB                                        
2015-11-18;         47;Apple                                             ;iPhone y Premium      ;                1;           0;                 1;               1;           2;S.C.                ;S.C.                ;           0;           0;          3;Terminales                                        ;APP 5 64GB                                        
2015-11-18;         47;Apple                                             ;iPhone y Premium      ;              105;          93;                24;             117;         222;175,5               ;333,0               ;           2;           2;          3;Terminales                                        ;APP 5C 16GB                                       
2015-11-18;         47;Apple                                             ;iPhone y Premium      ;               75;         401;                13;             414;         489;82,8                ;97,8                ;           3;          15;          3;Terminales                                        ;APP 5C 8GB                                        
2015-11-18;         47;Apple                                             ;iPhone y Premium      ;              239;        1083;              2163;            3246;        3485;9,4                 ;10,1                ;         240;        1036;          3;Terminales                                        ;APP 5S 16GB                                       
2015-11-18;         47;Apple                                             ;iPhone y Premium      ;               54;          61;                 8;              69;         123;S.C.                ;S.C.                ;           0;           0;          3;Terminales                                        ;APP 5S 32GB                                       
2015-11-18;         47;Apple                                             ;iPhone y Premium      ;               14;           4;                 0;               4;          18;12,0                ;54,0                ;           1;           1;          3;Terminales                                        ;APP 5S 64GB                                       
2015-11-18;         47;Apple                                             ;iPhone y Premium      ;               18;          60;                 1;              61;          79;36,6                ;47,4                ;           1;           5;          3;Terminales                                        ;APP 6 128GB                                       
2015-11-18;         47;Apple                                             ;iPhone y Premium      ;             4871;        3860;              1084;            4944;        9815;16,7                ;33,2                ;         289;         887;          3;Terminales                                        ;APP 6 16GB                                        
2015-11-18;         47;Apple                                             ;iPhone y Premium      ;                9;         535;                78;             613;         622;15,1                ;15,3                ;          51;         122;          3;Terminales                                        ;APP 6 64GB                                        
2015-11-18;         47;Apple                                             ;iPhone y Premium      ;               28;         262;                10;             272;         300;272,0               ;300,0               ;           0;           3;          3;Terminales                                        ;APP 6 Plus 16GB                                   
2015-11-18;         47;Apple                                             ;iPhone y Premium      ;                3;           8;                 0;               8;          11;S.C.                ;S.C.                ;           0;           0;          3;Terminales                                        ;APP 6 Plus 64GB                                   
2015-11-18;         47;Apple                                             ;iPhone y Premium      ;              204;         245;                69;             314;         518;27,7                ;45,7                ;          17;          34;          3;Terminales                                        ;APP 6S 128GB                                      
2015-11-18;         47;Apple                                             ;iPhone y Premium      ;             7207;        6090;               937;            7027;       14234;33,6                ;68,0                ;         176;         628;          3;Terminales                                        ;APP 6S 16GB                                       
2015-11-18;         47;Apple                                             ;iPhone y Premium      ;              479;        1422;               388;            1810;        2289;17,1                ;21,7                ;          94;         317;          3;Terminales                                        ;APP 6S 64GB                                       
2015-11-18;         47;Apple                                             ;iPhone y Premium      ;               11;           0;                 0;               0;          11;S.C.                ;S.C.                ;           0;           0;          3;Terminales                                        ;APP 6S DEMO                                       
2015-11-18;         47;Apple                                             ;iPhone y Premium      ;              922;        1492;               368;            1860;        2782;58,1                ;86,9                ;          23;          96;          3;Terminales                                        ;APP 6S PLUS 16GB                                  
2015-11-18;         47;Apple                                             ;iPhone y Premium      ;              631;         337;               103;             440;        1071;15,5                ;37,8                ;          28;          85;          3;Terminales                                        ;APP 6S PLUS 64GB                                  
2015-11-18;         47;Apple                                             ;iPhone y Premium      ;                6;           0;                 0;               0;           6;S.C.                ;S.C.                ;           0;           0;          3;Terminales                                        ;APP 6S PLUS DEMO                                  
2015-11-18;         47;Apple                                             ;iPhone y Premium      ;                1;           0;                 0;               0;           1;S.C.                ;S.C.                ;           0;           0;          3;Terminales                                        ;Apple Mini 32 GB                                  
2015-11-19;         47;Apple                                             ;iPhone y Premium      ;             2008;         695;               115;             810;        2818;37,2                ;129,6               ;          18;          87;          4;Peru                                              ;APP 6 Plus 16GB                                   
2015-11-19;         47;Apple                                             ;iPhone y Premium      ;               62;           0;                 0;               0;          62;S.C.                ;S.C.                ;           0;           0;          4;Terminales                                        ;APP 3GS 32GB                                      
2015-11-19;         47;Apple                                             ;iPhone y Premium      ;              101;           6;                 0;               6;         107;S.C.                ;S.C.                ;           0;           0;          4;Terminales                                        ;APP 3GS 8GB                                       
2015-11-19;         47;Apple                                             ;iPhone y Premium      ;               42;           0;                 0;               0;          42;S.C.                ;S.C.                ;           0;           0;          4;Terminales                                        ;APP 4 16GB                                        
2015-11-19;         47;Apple                                             ;iPhone y Premium      ;                9;           3;                 0;               3;          12;S.C.                ;S.C.                ;           0;           0;          4;Terminales                                        ;APP 4 32GB                                        
2015-11-19;         47;Apple                                             ;iPhone y Premium      ;              189;          39;                 1;              40;         229;S.C.                ;S.C.                ;           0;           0;          4;Terminales                                        ;APP 4 8GB                                         
2015-11-19;         47;Apple                                             ;iPhone y Premium      ;               14;          26;                 4;              30;          44;S.C.                ;S.C.                ;           0;           0;          4;Terminales                                        ;APP 4S 16GB                                       
2015-11-19;         47;Apple                                             ;iPhone y Premium      ;                3;           5;                 0;               5;           8;S.C.                ;S.C.                ;           0;           0;          4;Terminales                                        ;APP 4S 32GB                                       
2015-11-19;         47;Apple                                             ;iPhone y Premium      ;                0;           2;                 0;               2;           2;S.C.                ;S.C.                ;           0;           0;          4;Terminales                                        ;APP 4S 64GB                                       
2015-11-19;         47;Apple                                             ;iPhone y Premium      ;               36;         317;                 5;             322;         358;257,6               ;286,4               ;           3;           5;          4;Terminales                                        ;APP 4S 8GB                                        
2015-11-19;         47;Apple                                             ;iPhone y Premium      ;                4;           7;                 5;              12;          16;S.C.                ;S.C.                ;           0;           0;          4;Terminales                                        ;APP 5 16GB                                        
2015-11-19;         47;Apple                                             ;iPhone y Premium      ;                1;           1;                 0;               1;           2;S.C.                ;S.C.                ;           0;           0;          4;Terminales                                        ;APP 5 64GB                                        
2015-11-19;         47;Apple                                             ;iPhone y Premium      ;              105;          96;                20;             116;         221;116,0               ;221,0               ;           2;           4;          4;Terminales                                        ;APP 5C 16GB                                       
2015-11-19;         47;Apple                                             ;iPhone y Premium      ;               75;         468;                12;             480;         555;39,2                ;45,3                ;          34;          49;          4;Terminales                                        ;APP 5C 8GB                                        
2015-11-19;         47;Apple                                             ;iPhone y Premium      ;             2103;        1202;              1830;            3032;        5135;8,8                 ;14,9                ;         340;        1376;          4;Terminales                                        ;APP 5S 16GB                                       
2015-11-19;         47;Apple                                             ;iPhone y Premium      ;               54;          60;                 8;              68;         122;272,0               ;488,0               ;           1;           1;          4;Terminales                                        ;APP 5S 32GB                                       
2015-11-19;         47;Apple                                             ;iPhone y Premium      ;               14;           4;                 0;               4;          18;16,0                ;72,0                ;           0;           1;          4;Terminales                                        ;APP 5S 64GB                                       
2015-11-19;         47;Apple                                             ;iPhone y Premium      ;               18;          60;                 1;              61;          79;48,8                ;63,2                ;           0;           5;          4;Terminales                                        ;APP 6 128GB                                       
2015-11-19;         47;Apple                                             ;iPhone y Premium      ;             6052;        3994;               967;            4961;       11013;16,7                ;37,1                ;         299;        1186;          4;Terminales                                        ;APP 6 16GB                                        
2015-11-19;         47;Apple                                             ;iPhone y Premium      ;                7;         524;                49;             573;         580;14,0                ;14,1                ;          42;         164;          4;Terminales                                        ;APP 6 64GB                                        
2015-11-19;         47;Apple                                             ;iPhone y Premium      ;               28;         259;                 9;             268;         296;153,1               ;169,1               ;           4;           7;          4;Terminales                                        ;APP 6 Plus 16GB                                   
2015-11-19;         47;Apple                                             ;iPhone y Premium      ;                3;           8;                 0;               8;          11;S.C.                ;S.C.                ;           0;           0;          4;Terminales                                        ;APP 6 Plus 64GB                                   
2015-11-19;         47;Apple                                             ;iPhone y Premium      ;              199;         278;                33;             311;         510;29,6                ;48,6                ;           8;          42;          4;Terminales                                        ;APP 6S 128GB                                      
2015-11-19;         47;Apple                                             ;iPhone y Premium      ;             7006;        6235;               817;            7052;       14058;35,1                ;69,9                ;         176;         804;          4;Terminales                                        ;APP 6S 16GB                                       
2015-11-19;         47;Apple                                             ;iPhone y Premium      ;              400;        1410;               364;            1774;        2174;16,5                ;20,2                ;         113;         430;          4;Terminales                                        ;APP 6S 64GB                                       
2015-11-19;         47;Apple                                             ;iPhone y Premium      ;               11;           0;                 0;               0;          11;S.C.                ;S.C.                ;           0;           0;          4;Terminales                                        ;APP 6S DEMO                                       
2015-11-19;         47;Apple                                             ;iPhone y Premium      ;              857;        1609;               296;            1905;        2762;65,7                ;95,2                ;          20;         116;          4;Terminales                                        ;APP 6S PLUS 16GB                                  
2015-11-19;         47;Apple                                             ;iPhone y Premium      ;              623;         389;                30;             419;        1042;14,7                ;36,6                ;          29;         114;          4;Terminales                                        ;APP 6S PLUS 64GB                                  
2015-11-19;         47;Apple                                             ;iPhone y Premium      ;                6;           0;                 0;               0;           6;S.C.                ;S.C.                ;           0;           0;          4;Terminales                                        ;APP 6S PLUS DEMO                                  
2015-11-19;         47;Apple                                             ;iPhone y Premium      ;                1;           0;                 0;               0;           1;S.C.                ;S.C.                ;           0;           0;          4;Terminales                                        ;Apple Mini 32 GB                                  
2015-11-20;         47;Apple                                             ;iPhone y Premium      ;                0;           0;                 0;               0;           0;0,0                 ;0,0                 ;          26;         113;          5;Peru                                              ;APP 6 Plus 16GB                                   
2015-11-20;         47;Apple                                             ;iPhone y Premium      ;                0;           0;                 0;               0;           0;0,0                 ;0,0                 ;           5;          10;          5;Terminales                                        ;APP 4S 8GB                                        
2015-11-20;         47;Apple                                             ;iPhone y Premium      ;                0;           0;                 0;               0;           0;0,0                 ;0,0                 ;           1;           5;          5;Terminales                                        ;APP 5C 16GB                                       
2015-11-20;         47;Apple                                             ;iPhone y Premium      ;                0;           0;                 0;               0;           0;0,0                 ;0,0                 ;          70;         119;          5;Terminales                                        ;APP 5C 8GB                                        
2015-11-20;         47;Apple                                             ;iPhone y Premium      ;                0;           0;                 0;               0;           0;0,0                 ;0,0                 ;         530;        1906;          5;Terminales                                        ;APP 5S 16GB                                       
2015-11-20;         47;Apple                                             ;iPhone y Premium      ;                0;           0;                 0;               0;           0;0,0                 ;0,0                 ;           0;           1;          5;Terminales                                        ;APP 5S 32GB                                       
2015-11-20;         47;Apple                                             ;iPhone y Premium      ;                0;           0;                 0;               0;           0;S.C.                ;S.C.                ;          -1;           0;          5;Terminales                                        ;APP 5S 64GB                                       
2015-11-20;         47;Apple                                             ;iPhone y Premium      ;                0;           0;                 0;               0;           0;0,0                 ;0,0                 ;           0;           5;          5;Terminales                                        ;APP 6 128GB                                       
2015-11-20;         47;Apple                                             ;iPhone y Premium      ;                0;           0;                 0;               0;           0;0,0                 ;0,0                 ;         334;        1520;          5;Terminales                                        ;APP 6 16GB                                        
2015-11-20;         47;Apple                                             ;iPhone y Premium      ;                0;           0;                 0;               0;           0;0,0                 ;0,0                 ;          41;         205;          5;Terminales                                        ;APP 6 64GB                                        
2015-11-20;         47;Apple                                             ;iPhone y Premium      ;                0;           0;                 0;               0;           0;0,0                 ;0,0                 ;           2;           9;          5;Terminales                                        ;APP 6 Plus 16GB                                   
2015-11-20;         47;Apple                                             ;iPhone y Premium      ;                0;           0;                 0;               0;           0;0,0                 ;0,0                 ;          21;          63;          5;Terminales                                        ;APP 6S 128GB                                      
2015-11-20;         47;Apple                                             ;iPhone y Premium      ;                0;           0;                 0;               0;           0;0,0                 ;0,0                 ;         213;        1017;          5;Terminales                                        ;APP 6S 16GB                                       
2015-11-20;         47;Apple                                             ;iPhone y Premium      ;                0;           0;                 0;               0;           0;0,0                 ;0,0                 ;          99;         529;          5;Terminales                                        ;APP 6S 64GB                                       
2015-11-20;         47;Apple                                             ;iPhone y Premium      ;                0;           0;                 0;               0;           0;0,0                 ;0,0                 ;          35;         151;          5;Terminales                                        ;APP 6S PLUS 16GB                                  
2015-11-20;         47;Apple                                             ;iPhone y Premium      ;                0;           0;                 0;               0;           0;0,0                 ;0,0                 ;          29;         143;          5;Terminales                                        ;APP 6S PLUS 64GB                                  
2015-11-21;         47;Apple                                             ;iPhone y Premium      ;                0;           0;                 0;               0;           0;0,0                 ;0,0                 ;           6;         119;          6;Peru                                              ;APP 6 Plus 16GB                                   
2015-11-21;         47;Apple                                             ;iPhone y Premium      ;                0;           0;                 0;               0;           0;0,0                 ;0,0                 ;           0;          10;          6;Terminales                                        ;APP 4S 8GB                                        
2015-11-21;         47;Apple                                             ;iPhone y Premium      ;                0;           0;                 0;               0;           0;0,0                 ;0,0                 ;           0;           5;          6;Terminales                                        ;APP 5C 16GB                                       
2015-11-21;         47;Apple                                             ;iPhone y Premium      ;                0;           0;                 0;               0;           0;0,0                 ;0,0                 ;           1;         120;          6;Terminales                                        ;APP 5C 8GB                                        
2015-11-21;         47;Apple                                             ;iPhone y Premium      ;                0;           0;                 0;               0;           0;0,0                 ;0,0                 ;          47;        1953;          6;Terminales                                        ;APP 5S 16GB                                       
2015-11-21;         47;Apple                                             ;iPhone y Premium      ;                0;           0;                 0;               0;           0;0,0                 ;0,0                 ;           0;           1;          6;Terminales                                        ;APP 5S 32GB                                       
2015-11-21;         47;Apple                                             ;iPhone y Premium      ;                0;           0;                 0;               0;           0;S.C.                ;S.C.                ;           0;           0;          6;Terminales                                        ;APP 5S 64GB                                       
2015-11-21;         47;Apple                                             ;iPhone y Premium      ;                0;           0;                 0;               0;           0;0,0                 ;0,0                 ;           0;           5;          6;Terminales                                        ;APP 6 128GB                                       
2015-11-21;         47;Apple                                             ;iPhone y Premium      ;                0;           0;                 0;               0;           0;0,0                 ;0,0                 ;          68;        1588;          6;Terminales                                        ;APP 6 16GB                                        
2015-11-21;         47;Apple                                             ;iPhone y Premium      ;                0;           0;                 0;               0;           0;0,0                 ;0,0                 ;           2;         207;          6;Terminales                                        ;APP 6 64GB                                        
2015-11-21;         47;Apple                                             ;iPhone y Premium      ;                0;           0;                 0;               0;           0;0,0                 ;0,0                 ;           0;           9;          6;Terminales                                        ;APP 6 Plus 16GB                                   
2015-11-21;         47;Apple                                             ;iPhone y Premium      ;                0;           0;                 0;               0;           0;0,0                 ;0,0                 ;           0;          63;          6;Terminales                                        ;APP 6S 128GB                                      
2015-11-21;         47;Apple                                             ;iPhone y Premium      ;                0;           0;                 0;               0;           0;0,0                 ;0,0                 ;          64;        1081;          6;Terminales                                        ;APP 6S 16GB                                       
2015-11-21;         47;Apple                                             ;iPhone y Premium      ;                0;           0;                 0;               0;           0;0,0                 ;0,0                 ;           9;         538;          6;Terminales                                        ;APP 6S 64GB                                       
2015-11-21;         47;Apple                                             ;iPhone y Premium      ;                0;           0;                 0;               0;           0;0,0                 ;0,0                 ;          13;         164;          6;Terminales                                        ;APP 6S PLUS 16GB                                  
2015-11-21;         47;Apple                                             ;iPhone y Premium      ;                0;           0;                 0;               0;           0;0,0                 ;0,0                 ;           0;         143;          6;Terminales                                        ;APP 6S PLUS 64GB                                  
2015-11-22;         47;Apple                                             ;iPhone y Premium      ;             1999;         768;                19;             787;        2786;46,3                ;163,9               ;           0;         119;          7;Peru                                              ;APP 6 Plus 16GB                                   
2015-11-22;         47;Apple                                             ;iPhone y Premium      ;               62;           0;                 0;               0;          62;S.C.                ;S.C.                ;           0;           0;          7;Terminales                                        ;APP 3GS 32GB                                      
2015-11-22;         47;Apple                                             ;iPhone y Premium      ;              101;           6;                 0;               6;         107;S.C.                ;S.C.                ;           0;           0;          7;Terminales                                        ;APP 3GS 8GB                                       
2015-11-22;         47;Apple                                             ;iPhone y Premium      ;               42;           0;                 0;               0;          42;S.C.                ;S.C.                ;           0;           0;          7;Terminales                                        ;APP 4 16GB                                        
2015-11-22;         47;Apple                                             ;iPhone y Premium      ;                9;           3;                 0;               3;          12;S.C.                ;S.C.                ;           0;           0;          7;Terminales                                        ;APP 4 32GB                                        
2015-11-22;         47;Apple                                             ;iPhone y Premium      ;              189;          39;                 1;              40;         229;S.C.                ;S.C.                ;           0;           0;          7;Terminales                                        ;APP 4 8GB                                         
2015-11-22;         47;Apple                                             ;iPhone y Premium      ;               14;          26;                 4;              30;          44;S.C.                ;S.C.                ;           0;           0;          7;Terminales                                        ;APP 4S 16GB                                       
2015-11-22;         47;Apple                                             ;iPhone y Premium      ;                3;           5;                 0;               5;           8;S.C.                ;S.C.                ;           0;           0;          7;Terminales                                        ;APP 4S 32GB                                       
2015-11-22;         47;Apple                                             ;iPhone y Premium      ;                0;           2;                 0;               2;           2;S.C.                ;S.C.                ;           0;           0;          7;Terminales                                        ;APP 4S 64GB                                       
2015-11-22;         47;Apple                                             ;iPhone y Premium      ;               36;         312;                 6;             318;         354;202,4               ;225,3               ;           1;          11;          7;Terminales                                        ;APP 4S 8GB                                        
2015-11-22;         47;Apple                                             ;iPhone y Premium      ;                4;           7;                 5;              12;          16;S.C.                ;S.C.                ;           0;           0;          7;Terminales                                        ;APP 5 16GB                                        
2015-11-22;         47;Apple                                             ;iPhone y Premium      ;                1;           1;                 0;               1;           2;S.C.                ;S.C.                ;           0;           0;          7;Terminales                                        ;APP 5 64GB                                        
2015-11-22;         47;Apple                                             ;iPhone y Premium      ;              105;          96;                19;             115;         220;161,0               ;308,0               ;           0;           5;          7;Terminales                                        ;APP 5C 16GB                                       
2015-11-22;         47;Apple                                             ;iPhone y Premium      ;               56;         398;                12;             410;         466;23,9                ;27,2                ;           0;         120;          7;Terminales                                        ;APP 5C 8GB                                        
2015-11-22;         47;Apple                                             ;iPhone y Premium      ;             1523;        2131;               393;            2524;        4047;9,0                 ;14,4                ;          13;        1966;          7;Terminales                                        ;APP 5S 16GB                                       
2015-11-22;         47;Apple                                             ;iPhone y Premium      ;               54;          60;                 8;              68;         122;476,0               ;854,0               ;           0;           1;          7;Terminales                                        ;APP 5S 32GB                                       
2015-11-22;         47;Apple                                             ;iPhone y Premium      ;               14;           4;                 0;               4;          18;S.C.                ;S.C.                ;           0;           0;          7;Terminales                                        ;APP 5S 64GB                                       
2015-11-22;         47;Apple                                             ;iPhone y Premium      ;               18;          60;                 1;              61;          79;85,4                ;110,6               ;           0;           5;          7;Terminales                                        ;APP 6 128GB                                       
2015-11-22;         47;Apple                                             ;iPhone y Premium      ;             8280;        3757;               943;            4700;       12980;20,5                ;56,5                ;          20;        1608;          7;Terminales                                        ;APP 6 16GB                                        
2015-11-22;         47;Apple                                             ;iPhone y Premium      ;                7;         507;                21;             528;         535;17,9                ;18,1                ;           0;         207;          7;Terminales                                        ;APP 6 64GB                                        
2015-11-22;         47;Apple                                             ;iPhone y Premium      ;               28;         257;                 9;             266;         294;186,2               ;205,8               ;           1;          10;          7;Terminales                                        ;APP 6 Plus 16GB                                   
2015-11-22;         47;Apple                                             ;iPhone y Premium      ;                3;           8;                 0;               8;          11;S.C.                ;S.C.                ;           0;           0;          7;Terminales                                        ;APP 6 Plus 64GB                                   
2015-11-22;         47;Apple                                             ;iPhone y Premium      ;              185;         281;                23;             304;         489;33,8                ;54,3                ;           0;          63;          7;Terminales                                        ;APP 6S 128GB                                      
2015-11-22;         47;Apple                                             ;iPhone y Premium      ;             6604;        6252;               895;            7147;       13751;45,1                ;86,7                ;          29;        1110;          7;Terminales                                        ;APP 6S 16GB                                       
2015-11-22;         47;Apple                                             ;iPhone y Premium      ;              316;        1507;               240;            1747;        2063;22,6                ;26,6                ;           4;         542;          7;Terminales                                        ;APP 6S 64GB                                       
2015-11-22;         47;Apple                                             ;iPhone y Premium      ;               11;           0;                 0;               0;          11;S.C.                ;S.C.                ;           0;           0;          7;Terminales                                        ;APP 6S DEMO                                       
2015-11-22;         47;Apple                                             ;iPhone y Premium      ;              709;        1736;               263;            1999;        2708;82,8                ;112,2               ;           5;         169;          7;Terminales                                        ;APP 6S PLUS 16GB                                  
2015-11-22;         47;Apple                                             ;iPhone y Premium      ;              516;         374;               123;             497;        1013;24,3                ;49,6                ;           0;         143;          7;Terminales                                        ;APP 6S PLUS 64GB                                  
2015-11-22;         47;Apple                                             ;iPhone y Premium      ;                6;           0;                 0;               0;           6;S.C.                ;S.C.                ;           0;           0;          7;Terminales                                        ;APP 6S PLUS DEMO                                  
2015-11-22;         47;Apple                                             ;iPhone y Premium      ;                1;           0;                 0;               0;           1;S.C.                ;S.C.                ;           0;           0;          7;Terminales                                        ;Apple Mini 32 GB                                  
2015-11-23;         48;Apple                                             ;iPhone y Premium      ;             1983;         766;                25;             791;        2774;60,8                ;213,4               ;          13;          13;          1;Peru                                              ;APP 6 Plus 16GB                                   
2015-11-23;         48;Apple                                             ;iPhone y Premium      ;               62;           0;                 0;               0;          62;S.C.                ;S.C.                ;           0;           0;          1;Terminales                                        ;APP 3GS 32GB                                      
2015-11-23;         48;Apple                                             ;iPhone y Premium      ;              101;           6;                 0;               6;         107;S.C.                ;S.C.                ;           0;           0;          1;Terminales                                        ;APP 3GS 8GB                                       
2015-11-23;         48;Apple                                             ;iPhone y Premium      ;               42;           0;                 0;               0;          42;S.C.                ;S.C.                ;           0;           0;          1;Terminales                                        ;APP 4 16GB                                        
2015-11-23;         48;Apple                                             ;iPhone y Premium      ;               10;           3;                 0;               3;          13;S.C.                ;S.C.                ;           0;           0;          1;Terminales                                        ;APP 4 32GB                                        
2015-11-23;         48;Apple                                             ;iPhone y Premium      ;              189;          39;                 1;              40;         229;S.C.                ;S.C.                ;           0;           0;          1;Terminales                                        ;APP 4 8GB                                         
2015-11-23;         48;Apple                                             ;iPhone y Premium      ;               14;          26;                 4;              30;          44;S.C.                ;S.C.                ;           0;           0;          1;Terminales                                        ;APP 4S 16GB                                       
2015-11-23;         48;Apple                                             ;iPhone y Premium      ;                3;           5;                 0;               5;           8;S.C.                ;S.C.                ;           0;           0;          1;Terminales                                        ;APP 4S 32GB                                       
2015-11-23;         48;Apple                                             ;iPhone y Premium      ;                4;           2;                 0;               2;           6;S.C.                ;S.C.                ;           0;           0;          1;Terminales                                        ;APP 4S 64GB                                       
2015-11-23;         48;Apple                                             ;iPhone y Premium      ;               36;         312;                 5;             317;         353;317,0               ;353,0               ;           1;           1;          1;Terminales                                        ;APP 4S 8GB                                        
2015-11-23;         48;Apple                                             ;iPhone y Premium      ;                4;           7;                 5;              12;          16;S.C.                ;S.C.                ;           0;           0;          1;Terminales                                        ;APP 5 16GB                                        
2015-11-23;         48;Apple                                             ;iPhone y Premium      ;                1;           1;                 0;               1;           2;S.C.                ;S.C.                ;           0;           0;          1;Terminales                                        ;APP 5 64GB                                        
2015-11-23;         48;Apple                                             ;iPhone y Premium      ;              105;          96;                19;             115;         220;S.C.                ;S.C.                ;           0;           0;          1;Terminales                                        ;APP 5C 16GB                                       
2015-11-23;         48;Apple                                             ;iPhone y Premium      ;               58;         396;                12;             408;         466;136,0               ;155,3               ;           3;           3;          1;Terminales                                        ;APP 5C 8GB                                        
2015-11-23;         48;Apple                                             ;iPhone y Premium      ;             1393;        1747;               334;            2081;        3474;3,6                 ;5,9                 ;         585;         585;          1;Terminales                                        ;APP 5S 16GB                                       
2015-11-23;         48;Apple                                             ;iPhone y Premium      ;               56;          60;                 8;              68;         124;S.C.                ;S.C.                ;           0;           0;          1;Terminales                                        ;APP 5S 32GB                                       
2015-11-23;         48;Apple                                             ;iPhone y Premium      ;               16;           4;                 0;               4;          20;S.C.                ;S.C.                ;           0;           0;          1;Terminales                                        ;APP 5S 64GB                                       
2015-11-23;         48;Apple                                             ;iPhone y Premium      ;               18;          59;                 1;              60;          78;60,0                ;78,0                ;           1;           1;          1;Terminales                                        ;APP 6 128GB                                       
2015-11-23;         48;Apple                                             ;iPhone y Premium      ;             8232;        3910;               577;            4487;       12719;16,8                ;47,6                ;         267;         267;          1;Terminales                                        ;APP 6 16GB                                        
2015-11-23;         48;Apple                                             ;iPhone y Premium      ;                7;         464;                14;             478;         485;9,6                 ;9,7                 ;          50;          50;          1;Terminales                                        ;APP 6 64GB                                        
2015-11-23;         48;Apple                                             ;iPhone y Premium      ;               29;         255;                 9;             264;         293;88,0                ;97,7                ;           3;           3;          1;Terminales                                        ;APP 6 Plus 16GB                                   
2015-11-23;         48;Apple                                             ;iPhone y Premium      ;                3;           8;                 0;               8;          11;S.C.                ;S.C.                ;           0;           0;          1;Terminales                                        ;APP 6 Plus 64GB                                   
2015-11-23;         48;Apple                                             ;iPhone y Premium      ;              177;         287;                21;             308;         485;77,0                ;121,3               ;           4;           4;          1;Terminales                                        ;APP 6S 128GB                                      
2015-11-23;         48;Apple                                             ;iPhone y Premium      ;             6552;        6357;               633;            6990;       13542;34,6                ;67,0                ;         202;         202;          1;Terminales                                        ;APP 6S 16GB                                       
2015-11-23;         48;Apple                                             ;iPhone y Premium      ;              291;        1478;               176;            1654;        1945;15,2                ;17,8                ;         109;         109;          1;Terminales                                        ;APP 6S 64GB                                       
2015-11-23;         48;Apple                                             ;iPhone y Premium      ;               11;           0;                 0;               0;          11;S.C.                ;S.C.                ;           0;           0;          1;Terminales                                        ;APP 6S DEMO                                       
2015-11-23;         48;Apple                                             ;iPhone y Premium      ;              689;        1820;               161;            1981;        2670;66,0                ;89,0                ;          30;          30;          1;Terminales                                        ;APP 6S PLUS 16GB                                  
2015-11-23;         48;Apple                                             ;iPhone y Premium      ;              489;         415;                74;             489;         978;15,8                ;31,5                ;          31;          31;          1;Terminales                                        ;APP 6S PLUS 64GB                                  
2015-11-23;         48;Apple                                             ;iPhone y Premium      ;                6;           0;                 0;               0;           6;S.C.                ;S.C.                ;           0;           0;          1;Terminales                                        ;APP 6S PLUS DEMO                                  
2015-11-23;         48;Apple                                             ;iPhone y Premium      ;                1;           0;                 0;               0;           1;S.C.                ;S.C.                ;           0;           0;          1;Terminales                                        ;Apple Mini 32 GB                                  
2015-11-24;         48;Apple                                             ;iPhone y Premium      ;             1930;         769;                61;             830;        2760;57,2                ;190,3               ;          16;          29;          2;Peru                                              ;APP 6 Plus 16GB                                   
2015-11-24;         48;Apple                                             ;iPhone y Premium      ;               62;           0;                 0;               0;          62;S.C.                ;S.C.                ;           0;           0;          2;Terminales                                        ;APP 3GS 32GB                                      
2015-11-24;         48;Apple                                             ;iPhone y Premium      ;              101;           6;                 0;               6;         107;S.C.                ;S.C.                ;           0;           0;          2;Terminales                                        ;APP 3GS 8GB                                       
2015-11-24;         48;Apple                                             ;iPhone y Premium      ;               42;           0;                 0;               0;          42;S.C.                ;S.C.                ;           0;           0;          2;Terminales                                        ;APP 4 16GB                                        
2015-11-24;         48;Apple                                             ;iPhone y Premium      ;               10;           3;                 0;               3;          13;S.C.                ;S.C.                ;           0;           0;          2;Terminales                                        ;APP 4 32GB                                        
2015-11-24;         48;Apple                                             ;iPhone y Premium      ;              189;          38;                 1;              39;         228;S.C.                ;S.C.                ;           0;           0;          2;Terminales                                        ;APP 4 8GB                                         
2015-11-24;         48;Apple                                             ;iPhone y Premium      ;               14;          26;                 4;              30;          44;S.C.                ;S.C.                ;           0;           0;          2;Terminales                                        ;APP 4S 16GB                                       
2015-11-24;         48;Apple                                             ;iPhone y Premium      ;                3;           5;                 0;               5;           8;S.C.                ;S.C.                ;           0;           0;          2;Terminales                                        ;APP 4S 32GB                                       
2015-11-24;         48;Apple                                             ;iPhone y Premium      ;                4;           2;                 0;               2;           6;S.C.                ;S.C.                ;           0;           0;          2;Terminales                                        ;APP 4S 64GB                                       
2015-11-24;         48;Apple                                             ;iPhone y Premium      ;               36;         311;                 5;             316;         352;316,0               ;352,0               ;           1;           2;          2;Terminales                                        ;APP 4S 8GB                                        
2015-11-24;         48;Apple                                             ;iPhone y Premium      ;                4;           7;                 5;              12;          16;S.C.                ;S.C.                ;           0;           0;          2;Terminales                                        ;APP 5 16GB                                        
2015-11-24;         48;Apple                                             ;iPhone y Premium      ;                1;           1;                 0;               1;           2;S.C.                ;S.C.                ;           0;           0;          2;Terminales                                        ;APP 5 64GB                                        
2015-11-24;         48;Apple                                             ;iPhone y Premium      ;              105;          96;                19;             115;         220;S.C.                ;S.C.                ;           0;           0;          2;Terminales                                        ;APP 5C 16GB                                       
2015-11-24;         48;Apple                                             ;iPhone y Premium      ;               58;         396;                11;             407;         465;203,5               ;232,5               ;           1;           4;          2;Terminales                                        ;APP 5C 8GB                                        
2015-11-24;         48;Apple                                             ;iPhone y Premium      ;               68;        1320;              1543;            2863;        2931;5,1                 ;5,2                 ;         533;        1118;          2;Terminales                                        ;APP 5S 16GB                                       
2015-11-24;         48;Apple                                             ;iPhone y Premium      ;               56;          60;                 8;              68;         124;S.C.                ;S.C.                ;           0;           0;          2;Terminales                                        ;APP 5S 32GB                                       
2015-11-24;         48;Apple                                             ;iPhone y Premium      ;               16;           3;                 0;               3;          19;S.C.                ;S.C.                ;           0;           0;          2;Terminales                                        ;APP 5S 64GB                                       
2015-11-24;         48;Apple                                             ;iPhone y Premium      ;               18;          62;                 0;              62;          80;-124,0              ;-160,0              ;          -2;          -1;          2;Terminales                                        ;APP 6 128GB                                       
2015-11-24;         48;Apple                                             ;iPhone y Premium      ;             7809;        4058;               564;            4622;       12431;16,9                ;45,5                ;         280;         547;          2;Terminales                                        ;APP 6 16GB                                        
2015-11-24;         48;Apple                                             ;iPhone y Premium      ;                7;         435;                12;             447;         454;11,2                ;11,3                ;          30;          80;          2;Terminales                                        ;APP 6 64GB                                        
2015-11-24;         48;Apple                                             ;iPhone y Premium      ;               29;         252;                 9;             261;         290;130,5               ;145,0               ;           1;           4;          2;Terminales                                        ;APP 6 Plus 16GB                                   
2015-11-24;         48;Apple                                             ;iPhone y Premium      ;                3;           9;                 0;               9;          12;S.C.                ;S.C.                ;           0;           0;          2;Terminales                                        ;APP 6 Plus 64GB                                   
2015-11-24;         48;Apple                                             ;iPhone y Premium      ;              157;         291;                25;             316;         473;39,5                ;59,1                ;          12;          16;          2;Terminales                                        ;APP 6S 128GB                                      
2015-11-24;         48;Apple                                             ;iPhone y Premium      ;             6407;        6553;               402;            6955;       13362;37,3                ;71,6                ;         171;         373;          2;Terminales                                        ;APP 6S 16GB                                       
2015-11-24;         48;Apple                                             ;iPhone y Premium      ;              204;        1549;               113;            1662;        1866;17,8                ;20,0                ;          78;         187;          2;Terminales                                        ;APP 6S 64GB                                       
2015-11-24;         48;Apple                                             ;iPhone y Premium      ;               11;           0;                 0;               0;          11;S.C.                ;S.C.                ;           0;           0;          2;Terminales                                        ;APP 6S DEMO                                       
2015-11-24;         48;Apple                                             ;iPhone y Premium      ;              666;        1905;                78;            1983;        2649;84,4                ;112,7               ;          17;          47;          2;Terminales                                        ;APP 6S PLUS 16GB                                  
2015-11-24;         48;Apple                                             ;iPhone y Premium      ;              479;         445;                30;             475;         954;17,3                ;34,7                ;          24;          55;          2;Terminales                                        ;APP 6S PLUS 64GB                                  
2015-11-24;         48;Apple                                             ;iPhone y Premium      ;                6;           0;                 0;               0;           6;S.C.                ;S.C.                ;           0;           0;          2;Terminales                                        ;APP 6S PLUS DEMO                                  
2015-11-24;         48;Apple                                             ;iPhone y Premium      ;                1;           0;                 0;               0;           1;S.C.                ;S.C.                ;           0;           0;          2;Terminales                                        ;Apple Mini 32 GB                                  
2015-11-25;         48;Apple                                             ;iPhone y Premium      ;             1924;         755;                61;             816;        2740;51,0                ;171,3               ;          19;          48;          3;Peru                                              ;APP 6 Plus 16GB                                   
2015-11-25;         48;Apple                                             ;iPhone y Premium      ;               62;           0;                 0;               0;          62;S.C.                ;S.C.                ;           0;           0;          3;Terminales                                        ;APP 3GS 32GB                                      
2015-11-25;         48;Apple                                             ;iPhone y Premium      ;              101;           6;                 0;               6;         107;S.C.                ;S.C.                ;           0;           0;          3;Terminales                                        ;APP 3GS 8GB                                       
2015-11-25;         48;Apple                                             ;iPhone y Premium      ;               42;           0;                 0;               0;          42;S.C.                ;S.C.                ;           0;           0;          3;Terminales                                        ;APP 4 16GB                                        
2015-11-25;         48;Apple                                             ;iPhone y Premium      ;               10;           3;                 0;               3;          13;S.C.                ;S.C.                ;           0;           0;          3;Terminales                                        ;APP 4 32GB                                        
2015-11-25;         48;Apple                                             ;iPhone y Premium      ;              189;          38;                 1;              39;         228;S.C.                ;S.C.                ;           0;           0;          3;Terminales                                        ;APP 4 8GB                                         
2015-11-25;         48;Apple                                             ;iPhone y Premium      ;               14;          26;                 4;              30;          44;S.C.                ;S.C.                ;           0;           0;          3;Terminales                                        ;APP 4S 16GB                                       
2015-11-25;         48;Apple                                             ;iPhone y Premium      ;                3;           5;                 0;               5;           8;S.C.                ;S.C.                ;           0;           0;          3;Terminales                                        ;APP 4S 32GB                                       
2015-11-25;         48;Apple                                             ;iPhone y Premium      ;                4;           2;                 0;               2;           6;S.C.                ;S.C.                ;           0;           0;          3;Terminales                                        ;APP 4S 64GB                                       
2015-11-25;         48;Apple                                             ;iPhone y Premium      ;               36;         309;                 5;             314;         350;235,5               ;262,5               ;           2;           4;          3;Terminales                                        ;APP 4S 8GB                                        
2015-11-25;         48;Apple                                             ;iPhone y Premium      ;                4;           7;                 5;              12;          16;S.C.                ;S.C.                ;           0;           0;          3;Terminales                                        ;APP 5 16GB                                        
2015-11-25;         48;Apple                                             ;iPhone y Premium      ;                1;           1;                 0;               1;           2;S.C.                ;S.C.                ;           0;           0;          3;Terminales                                        ;APP 5 64GB                                        
2015-11-25;         48;Apple                                             ;iPhone y Premium      ;              105;         105;                10;             115;         220;S.C.                ;S.C.                ;           0;           0;          3;Terminales                                        ;APP 5C 16GB                                       
2015-11-25;         48;Apple                                             ;iPhone y Premium      ;               44;         386;                26;             412;         456;82,4                ;91,2                ;          11;          15;          3;Terminales                                        ;APP 5C 8GB                                        
2015-11-25;         48;Apple                                             ;iPhone y Premium      ;              228;        1249;              1345;            2594;        2822;5,5                 ;6,0                 ;         296;        1414;          3;Terminales                                        ;APP 5S 16GB                                       
2015-11-25;         48;Apple                                             ;iPhone y Premium      ;               56;          60;                 8;              68;         124;S.C.                ;S.C.                ;           0;           0;          3;Terminales                                        ;APP 5S 32GB                                       
2015-11-25;         48;Apple                                             ;iPhone y Premium      ;               16;           3;                 0;               3;          19;S.C.                ;S.C.                ;           0;           0;          3;Terminales                                        ;APP 5S 64GB                                       
2015-11-25;         48;Apple                                             ;iPhone y Premium      ;               18;          61;                 0;              61;          79;S.C.                ;S.C.                ;           1;           0;          3;Terminales                                        ;APP 6 128GB                                       
2015-11-25;         48;Apple                                             ;iPhone y Premium      ;             9040;        3860;               771;            4631;       13671;17,3                ;51,1                ;         255;         802;          3;Terminales                                        ;APP 6 16GB                                        
2015-11-25;         48;Apple                                             ;iPhone y Premium      ;                7;         391;                 9;             400;         407;10,7                ;10,9                ;          32;         112;          3;Terminales                                        ;APP 6 64GB                                        
2015-11-25;         48;Apple                                             ;iPhone y Premium      ;               29;         251;                 7;             258;         287;86,0                ;95,7                ;           5;           9;          3;Terminales                                        ;APP 6 Plus 16GB                                   
2015-11-25;         48;Apple                                             ;iPhone y Premium      ;                3;           9;                 0;               9;          12;S.C.                ;S.C.                ;           0;           0;          3;Terminales                                        ;APP 6 Plus 64GB                                   
2015-11-25;         48;Apple                                             ;iPhone y Premium      ;              456;         283;                26;             309;         765;38,6                ;95,6                ;           8;          24;          3;Terminales                                        ;APP 6S 128GB                                      
2015-11-25;         48;Apple                                             ;iPhone y Premium      ;            12858;        6453;               473;            6926;       19784;38,5                ;109,9               ;         167;         540;          3;Terminales                                        ;APP 6S 16GB                                       
2015-11-25;         48;Apple                                             ;iPhone y Premium      ;             2275;        1436;               136;            1572;        3847;15,8                ;38,7                ;         111;         298;          3;Terminales                                        ;APP 6S 64GB                                       
2015-11-25;         48;Apple                                             ;iPhone y Premium      ;               11;           0;                 0;               0;          11;S.C.                ;S.C.                ;           0;           0;          3;Terminales                                        ;APP 6S DEMO                                       
2015-11-25;         48;Apple                                             ;iPhone y Premium      ;              883;        1921;                83;            2004;        2887;93,9                ;135,3               ;          17;          64;          3;Terminales                                        ;APP 6S PLUS 16GB                                  
2015-11-25;         48;Apple                                             ;iPhone y Premium      ;              450;         423;                49;             472;         922;16,5                ;32,2                ;          31;          86;          3;Terminales                                        ;APP 6S PLUS 64GB                                  
2015-11-25;         48;Apple                                             ;iPhone y Premium      ;                6;           0;                 0;               0;           6;S.C.                ;S.C.                ;           0;           0;          3;Terminales                                        ;APP 6S PLUS DEMO                                  
2015-11-25;         48;Apple                                             ;iPhone y Premium      ;                1;           0;                 0;               0;           1;S.C.                ;S.C.                ;           0;           0;          3;Terminales                                        ;Apple Mini 32 GB                                  
2015-11-26;         48;Apple                                             ;iPhone y Premium      ;             1917;         747;                60;             807;        2724;51,2                ;173,0               ;          15;          63;          4;Peru                                              ;APP 6 Plus 16GB                                   
2015-11-26;         48;Apple                                             ;iPhone y Premium      ;               62;           0;                 0;               0;          62;S.C.                ;S.C.                ;           0;           0;          4;Terminales                                        ;APP 3GS 32GB                                      
2015-11-26;         48;Apple                                             ;iPhone y Premium      ;              101;           6;                 0;               6;         107;S.C.                ;S.C.                ;           0;           0;          4;Terminales                                        ;APP 3GS 8GB                                       
2015-11-26;         48;Apple                                             ;iPhone y Premium      ;               42;           0;                 0;               0;          42;S.C.                ;S.C.                ;           0;           0;          4;Terminales                                        ;APP 4 16GB                                        
2015-11-26;         48;Apple                                             ;iPhone y Premium      ;               10;           3;                 0;               3;          13;S.C.                ;S.C.                ;           0;           0;          4;Terminales                                        ;APP 4 32GB                                        
2015-11-26;         48;Apple                                             ;iPhone y Premium      ;              189;          38;                 1;              39;         228;S.C.                ;S.C.                ;           0;           0;          4;Terminales                                        ;APP 4 8GB                                         
2015-11-26;         48;Apple                                             ;iPhone y Premium      ;               14;          28;                 2;              30;          44;S.C.                ;S.C.                ;           0;           0;          4;Terminales                                        ;APP 4S 16GB                                       
2015-11-26;         48;Apple                                             ;iPhone y Premium      ;                3;           5;                 0;               5;           8;S.C.                ;S.C.                ;           0;           0;          4;Terminales                                        ;APP 4S 32GB                                       
2015-11-26;         48;Apple                                             ;iPhone y Premium      ;                4;           2;                 0;               2;           6;S.C.                ;S.C.                ;           0;           0;          4;Terminales                                        ;APP 4S 64GB                                       
2015-11-26;         48;Apple                                             ;iPhone y Premium      ;               36;         310;                 2;             312;         348;208,0               ;232,0               ;           2;           6;          4;Terminales                                        ;APP 4S 8GB                                        
2015-11-26;         48;Apple                                             ;iPhone y Premium      ;                4;           9;                 3;              12;          16;S.C.                ;S.C.                ;           0;           0;          4;Terminales                                        ;APP 5 16GB                                        
2015-11-26;         48;Apple                                             ;iPhone y Premium      ;                1;           1;                 0;               1;           2;S.C.                ;S.C.                ;           0;           0;          4;Terminales                                        ;APP 5 64GB                                        
2015-11-26;         48;Apple                                             ;iPhone y Premium      ;              105;         106;                 9;             115;         220;460,0               ;880,0               ;           1;           1;          4;Terminales                                        ;APP 5C 16GB                                       
2015-11-26;         48;Apple                                             ;iPhone y Premium      ;               44;         390;                22;             412;         456;86,7                ;96,0                ;           4;          19;          4;Terminales                                        ;APP 5C 8GB                                        
2015-11-26;         48;Apple                                             ;iPhone y Premium      ;              234;        1649;               516;            2165;        2399;4,7                 ;5,2                 ;         431;        1845;          4;Terminales                                        ;APP 5S 16GB                                       
2015-11-26;         48;Apple                                             ;iPhone y Premium      ;               56;          61;                 7;              68;         124;S.C.                ;S.C.                ;           0;           0;          4;Terminales                                        ;APP 5S 32GB                                       
2015-11-26;         48;Apple                                             ;iPhone y Premium      ;               16;           3;                 0;               3;          19;S.C.                ;S.C.                ;           0;           0;          4;Terminales                                        ;APP 5S 64GB                                       
2015-11-26;         48;Apple                                             ;iPhone y Premium      ;               18;          60;                 0;              60;          78;240,0               ;312,0               ;           1;           1;          4;Terminales                                        ;APP 6 128GB                                       
2015-11-26;         48;Apple                                             ;iPhone y Premium      ;             8828;        3799;               767;            4566;       13394;16,9                ;49,7                ;         277;        1079;          4;Terminales                                        ;APP 6 16GB                                        
2015-11-26;         48;Apple                                             ;iPhone y Premium      ;                7;         336;                11;             347;         354;8,3                 ;8,4                 ;          56;         168;          4;Terminales                                        ;APP 6 64GB                                        
2015-11-26;         48;Apple                                             ;iPhone y Premium      ;               29;         251;                 7;             258;         287;114,7               ;127,6               ;           0;           9;          4;Terminales                                        ;APP 6 Plus 16GB                                   
2015-11-26;         48;Apple                                             ;iPhone y Premium      ;                3;           8;                 0;               8;          11;S.C.                ;S.C.                ;           0;           0;          4;Terminales                                        ;APP 6 Plus 64GB                                   
2015-11-26;         48;Apple                                             ;iPhone y Premium      ;              425;         286;                42;             328;         753;37,5                ;86,1                ;          11;          35;          4;Terminales                                        ;APP 6S 128GB                                      
2015-11-26;         48;Apple                                             ;iPhone y Premium      ;            12738;        6462;               391;            6853;       19591;37,7                ;107,8               ;         187;         727;          4;Terminales                                        ;APP 6S 16GB                                       
2015-11-26;         48;Apple                                             ;iPhone y Premium      ;             2244;        1409;                78;            1487;        3731;14,5                ;36,3                ;         113;         411;          4;Terminales                                        ;APP 6S 64GB                                       
2015-11-26;         48;Apple                                             ;iPhone y Premium      ;               10;           0;                 0;               0;          10;S.C.                ;S.C.                ;           0;           0;          4;Terminales                                        ;APP 6S DEMO                                       
2015-11-26;         48;Apple                                             ;iPhone y Premium      ;              861;        1931;                75;            2006;        2867;101,6               ;145,2               ;          15;          79;          4;Terminales                                        ;APP 6S PLUS 16GB                                  
2015-11-26;         48;Apple                                             ;iPhone y Premium      ;              414;         421;                66;             487;         901;18,4                ;34,0                ;          20;         106;          4;Terminales                                        ;APP 6S PLUS 64GB                                  
2015-11-26;         48;Apple                                             ;iPhone y Premium      ;                6;           0;                 0;               0;           6;S.C.                ;S.C.                ;           0;           0;          4;Terminales                                        ;APP 6S PLUS DEMO                                  
2015-11-26;         48;Apple                                             ;iPhone y Premium      ;                1;           0;                 0;               0;           1;S.C.                ;S.C.                ;           0;           0;          4;Terminales                                        ;Apple Mini 32 GB                                  
2015-11-27;         48;Apple                                             ;iPhone y Premium      ;                0;           0;                 0;               0;           0;0,0                 ;0,0                 ;          16;          79;          5;Peru                                              ;APP 6 Plus 16GB                                   
2015-11-27;         48;Apple                                             ;iPhone y Premium      ;                0;           0;                 0;               0;           0;0,0                 ;0,0                 ;           1;           7;          5;Terminales                                        ;APP 4S 8GB                                        
2015-11-27;         48;Apple                                             ;iPhone y Premium      ;                0;           0;                 0;               0;           0;0,0                 ;0,0                 ;           0;           1;          5;Terminales                                        ;APP 5C 16GB                                       
2015-11-27;         48;Apple                                             ;iPhone y Premium      ;                0;           0;                 0;               0;           0;0,0                 ;0,0                 ;           5;          24;          5;Terminales                                        ;APP 5C 8GB                                        
2015-11-27;         48;Apple                                             ;iPhone y Premium      ;                0;           0;                 0;               0;           0;0,0                 ;0,0                 ;         383;        2228;          5;Terminales                                        ;APP 5S 16GB                                       
2015-11-27;         48;Apple                                             ;iPhone y Premium      ;                0;           0;                 0;               0;           0;0,0                 ;0,0                 ;           0;           1;          5;Terminales                                        ;APP 6 128GB                                       
2015-11-27;         48;Apple                                             ;iPhone y Premium      ;                0;           0;                 0;               0;           0;0,0                 ;0,0                 ;         275;        1354;          5;Terminales                                        ;APP 6 16GB                                        
2015-11-27;         48;Apple                                             ;iPhone y Premium      ;                0;           0;                 0;               0;           0;0,0                 ;0,0                 ;          19;         187;          5;Terminales                                        ;APP 6 64GB                                        
2015-11-27;         48;Apple                                             ;iPhone y Premium      ;                0;           0;                 0;               0;           0;0,0                 ;0,0                 ;           2;          11;          5;Terminales                                        ;APP 6 Plus 16GB                                   
2015-11-27;         48;Apple                                             ;iPhone y Premium      ;                0;           0;                 0;               0;           0;0,0                 ;0,0                 ;           9;          44;          5;Terminales                                        ;APP 6S 128GB                                      
2015-11-27;         48;Apple                                             ;iPhone y Premium      ;                0;           0;                 0;               0;           0;0,0                 ;0,0                 ;         205;         932;          5;Terminales                                        ;APP 6S 16GB                                       
2015-11-27;         48;Apple                                             ;iPhone y Premium      ;                0;           0;                 0;               0;           0;0,0                 ;0,0                 ;         113;         524;          5;Terminales                                        ;APP 6S 64GB                                       
2015-11-27;         48;Apple                                             ;iPhone y Premium      ;                0;           0;                 0;               0;           0;0,0                 ;0,0                 ;          45;         124;          5;Terminales                                        ;APP 6S PLUS 16GB                                  
2015-11-27;         48;Apple                                             ;iPhone y Premium      ;                0;           0;                 0;               0;           0;0,0                 ;0,0                 ;          16;         122;          5;Terminales                                        ;APP 6S PLUS 64GB                                  
2015-11-28;         48;Apple                                             ;iPhone y Premium      ;                0;           0;                 0;               0;           0;0,0                 ;0,0                 ;           5;          84;          6;Peru                                              ;APP 6 Plus 16GB                                   
2015-11-28;         48;Apple                                             ;iPhone y Premium      ;                0;           0;                 0;               0;           0;0,0                 ;0,0                 ;           1;           8;          6;Terminales                                        ;APP 4S 8GB                                        
2015-11-28;         48;Apple                                             ;iPhone y Premium      ;                0;           0;                 0;               0;           0;0,0                 ;0,0                 ;           0;           1;          6;Terminales                                        ;APP 5C 16GB                                       
2015-11-28;         48;Apple                                             ;iPhone y Premium      ;                0;           0;                 0;               0;           0;0,0                 ;0,0                 ;          12;          36;          6;Terminales                                        ;APP 5C 8GB                                        
2015-11-28;         48;Apple                                             ;iPhone y Premium      ;                0;           0;                 0;               0;           0;0,0                 ;0,0                 ;          70;        2298;          6;Terminales                                        ;APP 5S 16GB                                       
2015-11-28;         48;Apple                                             ;iPhone y Premium      ;                0;           0;                 0;               0;           0;0,0                 ;0,0                 ;           1;           1;          6;Terminales                                        ;APP 5S 32GB                                       
2015-11-28;         48;Apple                                             ;iPhone y Premium      ;                0;           0;                 0;               0;           0;0,0                 ;0,0                 ;           0;           1;          6;Terminales                                        ;APP 6 128GB                                       
2015-11-28;         48;Apple                                             ;iPhone y Premium      ;                0;           0;                 0;               0;           0;0,0                 ;0,0                 ;          82;        1436;          6;Terminales                                        ;APP 6 16GB                                        
2015-11-28;         48;Apple                                             ;iPhone y Premium      ;                0;           0;                 0;               0;           0;0,0                 ;0,0                 ;           1;         188;          6;Terminales                                        ;APP 6 64GB                                        
2015-11-28;         48;Apple                                             ;iPhone y Premium      ;                0;           0;                 0;               0;           0;0,0                 ;0,0                 ;           0;          11;          6;Terminales                                        ;APP 6 Plus 16GB                                   
2015-11-28;         48;Apple                                             ;iPhone y Premium      ;                0;           0;                 0;               0;           0;0,0                 ;0,0                 ;           1;          45;          6;Terminales                                        ;APP 6S 128GB                                      
2015-11-28;         48;Apple                                             ;iPhone y Premium      ;                0;           0;                 0;               0;           0;0,0                 ;0,0                 ;          88;        1020;          6;Terminales                                        ;APP 6S 16GB                                       
2015-11-28;         48;Apple                                             ;iPhone y Premium      ;                0;           0;                 0;               0;           0;0,0                 ;0,0                 ;          11;         535;          6;Terminales                                        ;APP 6S 64GB                                       
2015-11-28;         48;Apple                                             ;iPhone y Premium      ;                0;           0;                 0;               0;           0;0,0                 ;0,0                 ;           3;         127;          6;Terminales                                        ;APP 6S PLUS 16GB                                  
2015-11-28;         48;Apple                                             ;iPhone y Premium      ;                0;           0;                 0;               0;           0;0,0                 ;0,0                 ;           2;         124;          6;Terminales                                        ;APP 6S PLUS 64GB                                  
2015-11-29;         48;Apple                                             ;iPhone y Premium      ;             1788;         733;               178;             911;        2699;73,3                ;217,2               ;           3;          87;          7;Peru                                              ;APP 6 Plus 16GB                                   
2015-11-29;         48;Apple                                             ;iPhone y Premium      ;               62;           0;                 0;               0;          62;S.C.                ;S.C.                ;           0;           0;          7;Terminales                                        ;APP 3GS 32GB                                      
2015-11-29;         48;Apple                                             ;iPhone y Premium      ;              101;           6;                 0;               6;         107;S.C.                ;S.C.                ;           0;           0;          7;Terminales                                        ;APP 3GS 8GB                                       
2015-11-29;         48;Apple                                             ;iPhone y Premium      ;               42;           0;                 0;               0;          42;S.C.                ;S.C.                ;           0;           0;          7;Terminales                                        ;APP 4 16GB                                        
2015-11-29;         48;Apple                                             ;iPhone y Premium      ;               10;           3;                 0;               3;          13;S.C.                ;S.C.                ;           0;           0;          7;Terminales                                        ;APP 4 32GB                                        
2015-11-29;         48;Apple                                             ;iPhone y Premium      ;              189;          38;                 1;              39;         228;S.C.                ;S.C.                ;           0;           0;          7;Terminales                                        ;APP 4 8GB                                         
2015-11-29;         48;Apple                                             ;iPhone y Premium      ;               14;          28;                 2;              30;          44;S.C.                ;S.C.                ;           0;           0;          7;Terminales                                        ;APP 4S 16GB                                       
2015-11-29;         48;Apple                                             ;iPhone y Premium      ;                3;           5;                 0;               5;           8;S.C.                ;S.C.                ;           0;           0;          7;Terminales                                        ;APP 4S 32GB                                       
2015-11-29;         48;Apple                                             ;iPhone y Premium      ;                4;           2;                 0;               2;           6;S.C.                ;S.C.                ;           0;           0;          7;Terminales                                        ;APP 4S 64GB                                       
2015-11-29;         48;Apple                                             ;iPhone y Premium      ;               36;         312;                 2;             314;         350;274,8               ;306,3               ;           0;           8;          7;Terminales                                        ;APP 4S 8GB                                        
2015-11-29;         48;Apple                                             ;iPhone y Premium      ;                4;           9;                 3;              12;          16;S.C.                ;S.C.                ;           0;           0;          7;Terminales                                        ;APP 5 16GB                                        
2015-11-29;         48;Apple                                             ;iPhone y Premium      ;                1;           1;                 0;               1;           2;S.C.                ;S.C.                ;           0;           0;          7;Terminales                                        ;APP 5 64GB                                        
2015-11-29;         48;Apple                                             ;iPhone y Premium      ;              105;         105;                 9;             114;         219;798,0               ;1533,0              ;           0;           1;          7;Terminales                                        ;APP 5C 16GB                                       
2015-11-29;         48;Apple                                             ;iPhone y Premium      ;               44;         372;                21;             393;         437;70,5                ;78,4                ;           3;          39;          7;Terminales                                        ;APP 5C 8GB                                        
2015-11-29;         48;Apple                                             ;iPhone y Premium      ;              234;        1233;               506;            1739;        1973;5,3                 ;6,0                 ;          19;        2317;          7;Terminales                                        ;APP 5S 16GB                                       
2015-11-29;         48;Apple                                             ;iPhone y Premium      ;               56;          60;                 7;              67;         123;469,0               ;861,0               ;           0;           1;          7;Terminales                                        ;APP 5S 32GB                                       
2015-11-29;         48;Apple                                             ;iPhone y Premium      ;               16;           3;                 0;               3;          19;S.C.                ;S.C.                ;           0;           0;          7;Terminales                                        ;APP 5S 64GB                                       
2015-11-29;         48;Apple                                             ;iPhone y Premium      ;               18;          60;                 0;              60;          78;420,0               ;546,0               ;           0;           1;          7;Terminales                                        ;APP 6 128GB                                       
2015-11-29;         48;Apple                                             ;iPhone y Premium      ;             8368;        3888;               745;            4633;       13001;22,0                ;61,8                ;          37;        1473;          7;Terminales                                        ;APP 6 16GB                                        
2015-11-29;         48;Apple                                             ;iPhone y Premium      ;                8;         312;                 9;             321;         329;11,8                ;12,1                ;           2;         190;          7;Terminales                                        ;APP 6 64GB                                        
2015-11-29;         48;Apple                                             ;iPhone y Premium      ;                5;         249;                33;             282;         287;179,5               ;182,6               ;           0;          11;          7;Terminales                                        ;APP 6 Plus 16GB                                   
2015-11-29;         48;Apple                                             ;iPhone y Premium      ;                3;           8;                 0;               8;          11;S.C.                ;S.C.                ;           0;           0;          7;Terminales                                        ;APP 6 Plus 64GB                                   
2015-11-29;         48;Apple                                             ;iPhone y Premium      ;              325;         276;               142;             418;         743;65,0                ;115,6               ;           0;          45;          7;Terminales                                        ;APP 6S 128GB                                      
2015-11-29;         48;Apple                                             ;iPhone y Premium      ;            12520;        6244;               438;            6682;       19202;44,3                ;127,3               ;          36;        1056;          7;Terminales                                        ;APP 6S 16GB                                       
2015-11-29;         48;Apple                                             ;iPhone y Premium      ;             2219;        1296;                87;            1383;        3602;18,1                ;47,0                ;           1;         536;          7;Terminales                                        ;APP 6S 64GB                                       
2015-11-29;         48;Apple                                             ;iPhone y Premium      ;                9;           0;                 0;               0;           9;S.C.                ;S.C.                ;           0;           0;          7;Terminales                                        ;APP 6S DEMO                                       
2015-11-29;         48;Apple                                             ;iPhone y Premium      ;              786;        1897;               107;            2004;        2790;106,3               ;148,0               ;           5;         132;          7;Terminales                                        ;APP 6S PLUS 16GB                                  
2015-11-29;         48;Apple                                             ;iPhone y Premium      ;              179;         425;               278;             703;         882;39,4                ;49,4                ;           1;         125;          7;Terminales                                        ;APP 6S PLUS 64GB                                  
2015-11-29;         48;Apple                                             ;iPhone y Premium      ;                6;           0;                 0;               0;           6;S.C.                ;S.C.                ;           0;           0;          7;Terminales                                        ;APP 6S PLUS DEMO                                  
2015-11-29;         48;Apple                                             ;iPhone y Premium      ;                1;           0;                 0;               0;           1;S.C.                ;S.C.                ;           0;           0;          7;Terminales                                        ;Apple Mini 32 GB                                  
2015-11-30;         49;Apple                                             ;iPhone y Premium      ;             1711;         743;               225;             968;        2679;48,4                ;133,9               ;          20;          20;          1;Peru                                              ;APP 6 Plus 16GB                                   
2015-11-30;         49;Apple                                             ;iPhone y Premium      ;               62;           0;                 0;               0;          62;S.C.                ;S.C.                ;           0;           0;          1;Terminales                                        ;APP 3GS 32GB                                      
2015-11-30;         49;Apple                                             ;iPhone y Premium      ;              101;           6;                 0;               6;         107;S.C.                ;S.C.                ;           0;           0;          1;Terminales                                        ;APP 3GS 8GB                                       
2015-11-30;         49;Apple                                             ;iPhone y Premium      ;               42;           0;                 0;               0;          42;S.C.                ;S.C.                ;           0;           0;          1;Terminales                                        ;APP 4 16GB                                        
2015-11-30;         49;Apple                                             ;iPhone y Premium      ;               10;           3;                 0;               3;          13;S.C.                ;S.C.                ;           0;           0;          1;Terminales                                        ;APP 4 32GB                                        
2015-11-30;         49;Apple                                             ;iPhone y Premium      ;              189;          38;                 1;              39;         228;S.C.                ;S.C.                ;           0;           0;          1;Terminales                                        ;APP 4 8GB                                         
2015-11-30;         49;Apple                                             ;iPhone y Premium      ;               14;          28;                 2;              30;          44;S.C.                ;S.C.                ;           0;           0;          1;Terminales                                        ;APP 4S 16GB                                       
2015-11-30;         49;Apple                                             ;iPhone y Premium      ;                3;           5;                 0;               5;           8;S.C.                ;S.C.                ;           0;           0;          1;Terminales                                        ;APP 4S 32GB                                       
2015-11-30;         49;Apple                                             ;iPhone y Premium      ;                4;           2;                 0;               2;           6;S.C.                ;S.C.                ;           0;           0;          1;Terminales                                        ;APP 4S 64GB                                       
2015-11-30;         49;Apple                                             ;iPhone y Premium      ;               36;         311;                 2;             313;         349;313,0               ;349,0               ;           1;           1;          1;Terminales                                        ;APP 4S 8GB                                        
2015-11-30;         49;Apple                                             ;iPhone y Premium      ;                4;           9;                 3;              12;          16;S.C.                ;S.C.                ;           0;           0;          1;Terminales                                        ;APP 5 16GB                                        
2015-11-30;         49;Apple                                             ;iPhone y Premium      ;                1;           1;                 0;               1;           2;S.C.                ;S.C.                ;           0;           0;          1;Terminales                                        ;APP 5 64GB                                        
2015-11-30;         49;Apple                                             ;iPhone y Premium      ;              105;          84;                 9;              93;         198;S.C.                ;S.C.                ;           0;           0;          1;Terminales                                        ;APP 5C 16GB                                       
2015-11-30;         49;Apple                                             ;iPhone y Premium      ;               44;         385;                 7;             392;         436;392,0               ;436,0               ;           1;           1;          1;Terminales                                        ;APP 5C 8GB                                        
2015-11-30;         49;Apple                                             ;iPhone y Premium      ;              234;         992;               417;            1409;        1643;4,2                 ;4,9                 ;         334;         334;          1;Terminales                                        ;APP 5S 16GB                                       
2015-11-30;         49;Apple                                             ;iPhone y Premium      ;               56;          60;                 7;              67;         123;S.C.                ;S.C.                ;           0;           0;          1;Terminales                                        ;APP 5S 32GB                                       
2015-11-30;         49;Apple                                             ;iPhone y Premium      ;               16;           3;                 0;               3;          19;S.C.                ;S.C.                ;           0;           0;          1;Terminales                                        ;APP 5S 64GB                                       
2015-11-30;         49;Apple                                             ;iPhone y Premium      ;               18;          59;                 1;              60;          78;S.C.                ;S.C.                ;           0;           0;          1;Terminales                                        ;APP 6 128GB                                       
2015-11-30;         49;Apple                                             ;iPhone y Premium      ;             8130;        3796;               800;            4596;       12726;16,7                ;46,3                ;         275;         275;          1;Terminales                                        ;APP 6 16GB                                        
2015-11-30;         49;Apple                                             ;iPhone y Premium      ;                8;         294;                10;             304;         312;16,0                ;16,4                ;          19;          19;          1;Terminales                                        ;APP 6 64GB                                        
2015-11-30;         49;Apple                                             ;iPhone y Premium      ;                5;         274;                 7;             281;         286;281,0               ;286,0               ;           1;           1;          1;Terminales                                        ;APP 6 Plus 16GB                                   
2015-11-30;         49;Apple                                             ;iPhone y Premium      ;                3;           8;                 0;               8;          11;S.C.                ;S.C.                ;           0;           0;          1;Terminales                                        ;APP 6 Plus 64GB                                   
2015-11-30;         49;Apple                                             ;iPhone y Premium      ;              297;         325;               111;             436;         733;43,6                ;73,3                ;          10;          10;          1;Terminales                                        ;APP 6S 128GB                                      
2015-11-30;         49;Apple                                             ;iPhone y Premium      ;            12386;        6133;               475;            6608;       18994;32,7                ;94,0                ;         202;         202;          1;Terminales                                        ;APP 6S 16GB                                       
2015-11-30;         49;Apple                                             ;iPhone y Premium      ;             1972;        1245;               278;            1523;        3495;14,8                ;33,9                ;         103;         103;          1;Terminales                                        ;APP 6S 64GB                                       
2015-11-30;         49;Apple                                             ;iPhone y Premium      ;                9;           0;                 0;               0;           9;S.C.                ;S.C.                ;           0;           0;          1;Terminales                                        ;APP 6S DEMO                                       
2015-11-30;         49;Apple                                             ;iPhone y Premium      ;              709;        1900;               155;            2055;        2764;82,2                ;110,6               ;          25;          25;          1;Terminales                                        ;APP 6S PLUS 16GB                                  
2015-11-30;         49;Apple                                             ;iPhone y Premium      ;              160;         521;               170;             691;         851;21,6                ;26,6                ;          32;          32;          1;Terminales                                        ;APP 6S PLUS 64GB                                  
2015-11-30;         49;Apple                                             ;iPhone y Premium      ;                6;           0;                 0;               0;           6;S.C.                ;S.C.                ;           0;           0;          1;Terminales                                        ;APP 6S PLUS DEMO                                  
2015-11-30;         49;Apple                                             ;iPhone y Premium      ;                1;           0;                 0;               0;           1;S.C.                ;S.C.                ;           0;           0;          1;Terminales                                        ;Apple Mini 32 GB                                  
2015-11-16;         47;Blackberry                                        ;iPhone y Premium      ;                0;           2;                 0;               2;           2;S.C.                ;S.C.                ;           0;           0;          1;Terminales                                        ;BB 9800                                           
2015-11-16;         47;Blackberry                                        ;iPhone y Premium      ;                0;           1;                 0;               1;           1;S.C.                ;S.C.                ;           0;           0;          1;Terminales                                        ;BB 9810                                           
2015-11-16;         47;Blackberry                                        ;iPhone y Premium      ;                0;           1;                 0;               1;           1;S.C.                ;S.C.                ;           0;           0;          1;Terminales                                        ;BB 9900                                           
2015-11-16;         47;Blackberry                                        ;iPhone y Premium      ;                0;           1;                 0;               1;           1;S.C.                ;S.C.                ;           0;           0;          1;Terminales                                        ;BB Q10                                            
2015-11-16;         47;Blackberry                                        ;iPhone y Premium      ;                0;           0;                 2;               2;           2;S.C.                ;S.C.                ;           0;           0;          1;Terminales                                        ;BB Z10                                            
2015-11-16;         47;Blackberry                                        ;Smarthphones y Masivos;                0;           1;                 0;               1;           1;S.C.                ;S.C.                ;           0;           0;          1;Terminales                                        ;BB 9300                                           
2015-11-16;         47;Blackberry                                        ;Smarthphones y Masivos;                2;           0;                 0;               0;           2;S.C.                ;S.C.                ;           0;           0;          1;Terminales                                        ;BB 9320                                           
2015-11-16;         47;Blackberry                                        ;Smarthphones y Masivos;                0;           1;                 0;               1;           1;S.C.                ;S.C.                ;           0;           0;          1;Terminales                                        ;BB 9360                                           
2015-11-16;         47;Blackberry                                        ;Smarthphones y Masivos;                7;         242;                 0;             242;         249;S.C.                ;S.C.                ;           0;           0;          1;Terminales                                        ;BB 9720                                           
2015-11-17;         47;Blackberry                                        ;iPhone y Premium      ;                0;           2;                 0;               2;           2;S.C.                ;S.C.                ;           0;           0;          2;Terminales                                        ;BB 9800                                           
2015-11-17;         47;Blackberry                                        ;iPhone y Premium      ;                0;           1;                 0;               1;           1;S.C.                ;S.C.                ;           0;           0;          2;Terminales                                        ;BB 9810                                           
2015-11-17;         47;Blackberry                                        ;iPhone y Premium      ;                0;           1;                 0;               1;           1;S.C.                ;S.C.                ;           0;           0;          2;Terminales                                        ;BB 9900                                           
2015-11-17;         47;Blackberry                                        ;iPhone y Premium      ;                0;           1;                 0;               1;           1;S.C.                ;S.C.                ;           0;           0;          2;Terminales                                        ;BB Q10                                            
2015-11-17;         47;Blackberry                                        ;iPhone y Premium      ;                0;           0;                 2;               2;           2;S.C.                ;S.C.                ;           0;           0;          2;Terminales                                        ;BB Z10                                            
2015-11-17;         47;Blackberry                                        ;Smarthphones y Masivos;                0;           1;                 0;               1;           1;S.C.                ;S.C.                ;           0;           0;          2;Terminales                                        ;BB 9300                                           
2015-11-17;         47;Blackberry                                        ;Smarthphones y Masivos;                2;           0;                 0;               0;           2;S.C.                ;S.C.                ;           0;           0;          2;Terminales                                        ;BB 9320                                           
2015-11-17;         47;Blackberry                                        ;Smarthphones y Masivos;                0;           1;                 0;               1;           1;S.C.                ;S.C.                ;           0;           0;          2;Terminales                                        ;BB 9360                                           
2015-11-17;         47;Blackberry                                        ;Smarthphones y Masivos;                7;         235;                 0;             235;         242;67,1                ;69,1                ;           7;           7;          2;Terminales                                        ;BB 9720                                           
2015-11-18;         47;Blackberry                                        ;iPhone y Premium      ;                0;           2;                 0;               2;           2;S.C.                ;S.C.                ;           0;           0;          3;Terminales                                        ;BB 9800                                           
2015-11-18;         47;Blackberry                                        ;iPhone y Premium      ;                0;           1;                 0;               1;           1;S.C.                ;S.C.                ;           0;           0;          3;Terminales                                        ;BB 9810                                           
2015-11-18;         47;Blackberry                                        ;iPhone y Premium      ;                0;           1;                 0;               1;           1;S.C.                ;S.C.                ;           0;           0;          3;Terminales                                        ;BB 9900                                           
2015-11-18;         47;Blackberry                                        ;iPhone y Premium      ;                0;           1;                 0;               1;           1;S.C.                ;S.C.                ;           0;           0;          3;Terminales                                        ;BB Q10                                            
2015-11-18;         47;Blackberry                                        ;iPhone y Premium      ;                0;           0;                 2;               2;           2;S.C.                ;S.C.                ;           0;           0;          3;Terminales                                        ;BB Z10                                            
2015-11-18;         47;Blackberry                                        ;Smarthphones y Masivos;                0;           1;                 0;               1;           1;S.C.                ;S.C.                ;           0;           0;          3;Terminales                                        ;BB 9300                                           
2015-11-18;         47;Blackberry                                        ;Smarthphones y Masivos;                2;           0;                 0;               0;           2;S.C.                ;S.C.                ;           0;           0;          3;Terminales                                        ;BB 9320                                           
2015-11-18;         47;Blackberry                                        ;Smarthphones y Masivos;                0;           1;                 0;               1;           1;S.C.                ;S.C.                ;           0;           0;          3;Terminales                                        ;BB 9360                                           
2015-11-18;         47;Blackberry                                        ;Smarthphones y Masivos;                7;         234;                 0;             234;         241;87,8                ;90,4                ;           1;           8;          3;Terminales                                        ;BB 9720                                           
2015-11-19;         47;Blackberry                                        ;iPhone y Premium      ;                0;           2;                 0;               2;           2;S.C.                ;S.C.                ;           0;           0;          4;Terminales                                        ;BB 9800                                           
2015-11-19;         47;Blackberry                                        ;iPhone y Premium      ;                0;           1;                 0;               1;           1;S.C.                ;S.C.                ;           0;           0;          4;Terminales                                        ;BB 9810                                           
2015-11-19;         47;Blackberry                                        ;iPhone y Premium      ;                0;           1;                 0;               1;           1;S.C.                ;S.C.                ;           0;           0;          4;Terminales                                        ;BB 9900                                           
2015-11-19;         47;Blackberry                                        ;iPhone y Premium      ;                0;           1;                 0;               1;           1;S.C.                ;S.C.                ;           0;           0;          4;Terminales                                        ;BB Q10                                            
2015-11-19;         47;Blackberry                                        ;iPhone y Premium      ;                0;           1;                 1;               2;           2;S.C.                ;S.C.                ;           0;           0;          4;Terminales                                        ;BB Z10                                            
2015-11-19;         47;Blackberry                                        ;Smarthphones y Masivos;                0;           1;                 0;               1;           1;S.C.                ;S.C.                ;           0;           0;          4;Terminales                                        ;BB 9300                                           
2015-11-19;         47;Blackberry                                        ;Smarthphones y Masivos;                2;           0;                 0;               0;           2;S.C.                ;S.C.                ;           0;           0;          4;Terminales                                        ;BB 9320                                           
2015-11-19;         47;Blackberry                                        ;Smarthphones y Masivos;                0;           1;                 0;               1;           1;S.C.                ;S.C.                ;           0;           0;          4;Terminales                                        ;BB 9360                                           
2015-11-19;         47;Blackberry                                        ;Smarthphones y Masivos;                7;         234;                 0;             234;         241;117,0               ;120,5               ;           0;           8;          4;Terminales                                        ;BB 9720                                           
2015-11-20;         47;Blackberry                                        ;Smarthphones y Masivos;                0;           0;                 0;               0;           0;0,0                 ;0,0                 ;           0;           8;          5;Terminales                                        ;BB 9720                                           
2015-11-21;         47;Blackberry                                        ;Smarthphones y Masivos;                0;           0;                 0;               0;           0;0,0                 ;0,0                 ;           0;           8;          6;Terminales                                        ;BB 9720                                           
2015-11-22;         47;Blackberry                                        ;iPhone y Premium      ;                0;           2;                 0;               2;           2;S.C.                ;S.C.                ;           0;           0;          7;Terminales                                        ;BB 9800                                           
2015-11-22;         47;Blackberry                                        ;iPhone y Premium      ;                0;           1;                 0;               1;           1;S.C.                ;S.C.                ;           0;           0;          7;Terminales                                        ;BB 9810                                           
2015-11-22;         47;Blackberry                                        ;iPhone y Premium      ;                0;           1;                 0;               1;           1;S.C.                ;S.C.                ;           0;           0;          7;Terminales                                        ;BB 9900                                           
2015-11-22;         47;Blackberry                                        ;iPhone y Premium      ;                0;           1;                 0;               1;           1;S.C.                ;S.C.                ;           0;           0;          7;Terminales                                        ;BB Q10                                            
2015-11-22;         47;Blackberry                                        ;iPhone y Premium      ;                0;           1;                 1;               2;           2;S.C.                ;S.C.                ;           0;           0;          7;Terminales                                        ;BB Z10                                            
2015-11-22;         47;Blackberry                                        ;Smarthphones y Masivos;                0;           1;                 0;               1;           1;S.C.                ;S.C.                ;           0;           0;          7;Terminales                                        ;BB 9300                                           
2015-11-22;         47;Blackberry                                        ;Smarthphones y Masivos;                2;           0;                 0;               0;           2;S.C.                ;S.C.                ;           0;           0;          7;Terminales                                        ;BB 9320                                           
2015-11-22;         47;Blackberry                                        ;Smarthphones y Masivos;                0;           1;                 0;               1;           1;S.C.                ;S.C.                ;           0;           0;          7;Terminales                                        ;BB 9360                                           
2015-11-22;         47;Blackberry                                        ;Smarthphones y Masivos;                7;         234;                 0;             234;         241;204,8               ;210,9               ;           0;           8;          7;Terminales                                        ;BB 9720                                           
2015-11-23;         48;Blackberry                                        ;iPhone y Premium      ;                0;           2;                 0;               2;           2;S.C.                ;S.C.                ;           0;           0;          1;Terminales                                        ;BB 9800                                           
2015-11-23;         48;Blackberry                                        ;iPhone y Premium      ;                0;           1;                 0;               1;           1;S.C.                ;S.C.                ;           0;           0;          1;Terminales                                        ;BB 9810                                           
2015-11-23;         48;Blackberry                                        ;iPhone y Premium      ;                0;           1;                 0;               1;           1;S.C.                ;S.C.                ;           0;           0;          1;Terminales                                        ;BB 9900                                           
2015-11-23;         48;Blackberry                                        ;iPhone y Premium      ;                0;           1;                 0;               1;           1;S.C.                ;S.C.                ;           0;           0;          1;Terminales                                        ;BB Q10                                            
2015-11-23;         48;Blackberry                                        ;iPhone y Premium      ;                0;           2;                 0;               2;           2;S.C.                ;S.C.                ;           0;           0;          1;Terminales                                        ;BB Z10                                            
2015-11-23;         48;Blackberry                                        ;Smarthphones y Masivos;                0;           1;                 0;               1;           1;S.C.                ;S.C.                ;           0;           0;          1;Terminales                                        ;BB 9300                                           
2015-11-23;         48;Blackberry                                        ;Smarthphones y Masivos;                2;           0;                 0;               0;           2;S.C.                ;S.C.                ;           0;           0;          1;Terminales                                        ;BB 9320                                           
2015-11-23;         48;Blackberry                                        ;Smarthphones y Masivos;                0;           1;                 0;               1;           1;S.C.                ;S.C.                ;           0;           0;          1;Terminales                                        ;BB 9360                                           
2015-11-23;         48;Blackberry                                        ;Smarthphones y Masivos;                7;         234;                 0;             234;         241;S.C.                ;S.C.                ;           0;           0;          1;Terminales                                        ;BB 9720                                           
2015-11-24;         48;Blackberry                                        ;iPhone y Premium      ;                0;           2;                 0;               2;           2;S.C.                ;S.C.                ;           0;           0;          2;Terminales                                        ;BB 9800                                           
2015-11-24;         48;Blackberry                                        ;iPhone y Premium      ;                0;           1;                 0;               1;           1;S.C.                ;S.C.                ;           0;           0;          2;Terminales                                        ;BB 9810                                           
2015-11-24;         48;Blackberry                                        ;iPhone y Premium      ;                0;           1;                 0;               1;           1;S.C.                ;S.C.                ;           0;           0;          2;Terminales                                        ;BB 9900                                           
2015-11-24;         48;Blackberry                                        ;iPhone y Premium      ;                0;           1;                 0;               1;           1;S.C.                ;S.C.                ;           0;           0;          2;Terminales                                        ;BB Q10                                            
2015-11-24;         48;Blackberry                                        ;iPhone y Premium      ;                0;           1;                 0;               1;           1;2,0                 ;2,0                 ;           1;           1;          2;Terminales                                        ;BB Z10                                            
2015-11-24;         48;Blackberry                                        ;Smarthphones y Masivos;                0;           1;                 0;               1;           1;S.C.                ;S.C.                ;           0;           0;          2;Terminales                                        ;BB 9300                                           
2015-11-24;         48;Blackberry                                        ;Smarthphones y Masivos;                2;           0;                 0;               0;           2;S.C.                ;S.C.                ;           0;           0;          2;Terminales                                        ;BB 9320                                           
2015-11-24;         48;Blackberry                                        ;Smarthphones y Masivos;                0;           1;                 0;               1;           1;S.C.                ;S.C.                ;           0;           0;          2;Terminales                                        ;BB 9360                                           
2015-11-24;         48;Blackberry                                        ;Smarthphones y Masivos;                7;         234;                 0;             234;         241;S.C.                ;S.C.                ;           0;           0;          2;Terminales                                        ;BB 9720                                           
2015-11-25;         48;Blackberry                                        ;iPhone y Premium      ;                0;           2;                 0;               2;           2;S.C.                ;S.C.                ;           0;           0;          3;Terminales                                        ;BB 9800                                           
2015-11-25;         48;Blackberry                                        ;iPhone y Premium      ;                0;           1;                 0;               1;           1;S.C.                ;S.C.                ;           0;           0;          3;Terminales                                        ;BB 9810                                           
2015-11-25;         48;Blackberry                                        ;iPhone y Premium      ;                0;           1;                 0;               1;           1;S.C.                ;S.C.                ;           0;           0;          3;Terminales                                        ;BB 9900                                           
2015-11-25;         48;Blackberry                                        ;iPhone y Premium      ;                0;           1;                 0;               1;           1;S.C.                ;S.C.                ;           0;           0;          3;Terminales                                        ;BB Q10                                            
2015-11-25;         48;Blackberry                                        ;iPhone y Premium      ;                0;           1;                 0;               1;           1;3,0                 ;3,0                 ;           0;           1;          3;Terminales                                        ;BB Z10                                            
2015-11-25;         48;Blackberry                                        ;Smarthphones y Masivos;                0;           1;                 0;               1;           1;S.C.                ;S.C.                ;           0;           0;          3;Terminales                                        ;BB 9300                                           
2015-11-25;         48;Blackberry                                        ;Smarthphones y Masivos;                2;           0;                 0;               0;           2;S.C.                ;S.C.                ;           0;           0;          3;Terminales                                        ;BB 9320                                           
2015-11-25;         48;Blackberry                                        ;Smarthphones y Masivos;                0;           1;                 0;               1;           1;S.C.                ;S.C.                ;           0;           0;          3;Terminales                                        ;BB 9360                                           
2015-11-25;         48;Blackberry                                        ;Smarthphones y Masivos;                7;         234;                 0;             234;         241;S.C.                ;S.C.                ;           0;           0;          3;Terminales                                        ;BB 9720                                           
2015-11-26;         48;Blackberry                                        ;iPhone y Premium      ;                0;           2;                 0;               2;           2;S.C.                ;S.C.                ;           0;           0;          4;Terminales                                        ;BB 9800                                           
2015-11-26;         48;Blackberry                                        ;iPhone y Premium      ;                0;           1;                 0;               1;           1;S.C.                ;S.C.                ;           0;           0;          4;Terminales                                        ;BB 9810                                           
2015-11-26;         48;Blackberry                                        ;iPhone y Premium      ;                0;           1;                 0;               1;           1;S.C.                ;S.C.                ;           0;           0;          4;Terminales                                        ;BB 9900                                           
2015-11-26;         48;Blackberry                                        ;iPhone y Premium      ;                0;           1;                 0;               1;           1;S.C.                ;S.C.                ;           0;           0;          4;Terminales                                        ;BB Q10                                            
2015-11-26;         48;Blackberry                                        ;iPhone y Premium      ;                0;           1;                 1;               2;           2;8,0                 ;8,0                 ;           0;           1;          4;Terminales                                        ;BB Z10                                            
2015-11-26;         48;Blackberry                                        ;Smarthphones y Masivos;                0;           1;                 0;               1;           1;S.C.                ;S.C.                ;           0;           0;          4;Terminales                                        ;BB 9300                                           
2015-11-26;         48;Blackberry                                        ;Smarthphones y Masivos;                2;           0;                 0;               0;           2;S.C.                ;S.C.                ;           0;           0;          4;Terminales                                        ;BB 9320                                           
2015-11-26;         48;Blackberry                                        ;Smarthphones y Masivos;                0;           1;                 0;               1;           1;S.C.                ;S.C.                ;           0;           0;          4;Terminales                                        ;BB 9360                                           
2015-11-26;         48;Blackberry                                        ;Smarthphones y Masivos;                7;         234;                 1;             235;         242;S.C.                ;S.C.                ;           0;           0;          4;Terminales                                        ;BB 9720                                           
2015-11-27;         48;Blackberry                                        ;iPhone y Premium      ;                0;           0;                 0;               0;           0;0,0                 ;0,0                 ;           0;           1;          5;Terminales                                        ;BB Z10                                            
2015-11-27;         48;Blackberry                                        ;Smarthphones y Masivos;                0;           0;                 0;               0;           0;S.C.                ;S.C.                ;           0;           0;          5;Terminales                                        ;BB 9720                                           
2015-11-28;         48;Blackberry                                        ;iPhone y Premium      ;                0;           0;                 0;               0;           0;0,0                 ;0,0                 ;           0;           1;          6;Terminales                                        ;BB Z10                                            
2015-11-28;         48;Blackberry                                        ;Smarthphones y Masivos;                0;           0;                 0;               0;           0;S.C.                ;S.C.                ;           0;           0;          6;Terminales                                        ;BB 9720                                           
2015-11-29;         48;Blackberry                                        ;iPhone y Premium      ;                0;           2;                 0;               2;           2;S.C.                ;S.C.                ;           0;           0;          7;Terminales                                        ;BB 9800                                           
2015-11-29;         48;Blackberry                                        ;iPhone y Premium      ;                0;           1;                 0;               1;           1;S.C.                ;S.C.                ;           0;           0;          7;Terminales                                        ;BB 9810                                           
2015-11-29;         48;Blackberry                                        ;iPhone y Premium      ;                0;           1;                 0;               1;           1;S.C.                ;S.C.                ;           0;           0;          7;Terminales                                        ;BB 9900                                           
2015-11-29;         48;Blackberry                                        ;iPhone y Premium      ;                0;           1;                 0;               1;           1;S.C.                ;S.C.                ;           0;           0;          7;Terminales                                        ;BB Q10                                            
2015-11-29;         48;Blackberry                                        ;iPhone y Premium      ;                0;           2;                 0;               2;           2;14,0                ;14,0                ;           0;           1;          7;Terminales                                        ;BB Z10                                            
2015-11-29;         48;Blackberry                                        ;Smarthphones y Masivos;                0;           1;                 0;               1;           1;S.C.                ;S.C.                ;           0;           0;          7;Terminales                                        ;BB 9300                                           
2015-11-29;         48;Blackberry                                        ;Smarthphones y Masivos;                2;           0;                 0;               0;           2;S.C.                ;S.C.                ;           0;           0;          7;Terminales                                        ;BB 9320                                           
2015-11-29;         48;Blackberry                                        ;Smarthphones y Masivos;                0;           1;                 0;               1;           1;S.C.                ;S.C.                ;           0;           0;          7;Terminales                                        ;BB 9360                                           
2015-11-29;         48;Blackberry                                        ;Smarthphones y Masivos;                7;         233;                 1;             234;         241;S.C.                ;S.C.                ;           0;           0;          7;Terminales                                        ;BB 9720                                           
2015-11-30;         49;Blackberry                                        ;iPhone y Premium      ;                0;           2;                 0;               2;           2;S.C.                ;S.C.                ;           0;           0;          1;Terminales                                        ;BB 9800                                           
2015-11-30;         49;Blackberry                                        ;iPhone y Premium      ;                0;           1;                 0;               1;           1;S.C.                ;S.C.                ;           0;           0;          1;Terminales                                        ;BB 9810                                           
2015-11-30;         49;Blackberry                                        ;iPhone y Premium      ;                0;           1;                 0;               1;           1;S.C.                ;S.C.                ;           0;           0;          1;Terminales                                        ;BB 9900                                           
2015-11-30;         49;Blackberry                                        ;iPhone y Premium      ;                0;           1;                 0;               1;           1;S.C.                ;S.C.                ;           0;           0;          1;Terminales                                        ;BB Q10                                            
2015-11-30;         49;Blackberry                                        ;iPhone y Premium      ;                0;           1;                 0;               1;           1;1,0                 ;1,0                 ;           1;           1;          1;Terminales                                        ;BB Z10                                            
2015-11-30;         49;Blackberry                                        ;Smarthphones y Masivos;                0;           1;                 0;               1;           1;S.C.                ;S.C.                ;           0;           0;          1;Terminales                                        ;BB 9300                                           
2015-11-30;         49;Blackberry                                        ;Smarthphones y Masivos;                2;           0;                 0;               0;           2;S.C.                ;S.C.                ;           0;           0;          1;Terminales                                        ;BB 9320                                           
2015-11-30;         49;Blackberry                                        ;Smarthphones y Masivos;                0;           1;                 0;               1;           1;S.C.                ;S.C.                ;           0;           0;          1;Terminales                                        ;BB 9360                                           
2015-11-30;         49;Blackberry                                        ;Smarthphones y Masivos;                7;         234;                 0;             234;         241;S.C.                ;S.C.                ;           0;           0;          1;Terminales                                        ;BB 9720                                           
2015-11-24;         48;Caterpillar                                       ;Smarthphones y Masivos;                0;           1;                 0;               1;           1;S.C.                ;S.C.                ;           0;           0;          2;Terminales                                        ;CAT B10                                           
2015-11-25;         48;Caterpillar                                       ;Smarthphones y Masivos;                0;           1;                 0;               1;           1;S.C.                ;S.C.                ;           0;           0;          3;Terminales                                        ;CAT B10                                           
2015-11-26;         48;Caterpillar                                       ;Smarthphones y Masivos;                0;           1;                 0;               1;           1;S.C.                ;S.C.                ;           0;           0;          4;Terminales                                        ;CAT B10                                           
2015-11-29;         48;Caterpillar                                       ;Smarthphones y Masivos;                0;           1;                 0;               1;           1;S.C.                ;S.C.                ;           0;           0;          7;Terminales                                        ;CAT B10                                           
2015-11-30;         49;Caterpillar                                       ;Smarthphones y Masivos;                0;           1;                 0;               1;           1;S.C.                ;S.C.                ;           0;           0;          1;Terminales                                        ;CAT B10                                           
2015-11-16;         47;HKM                                               ;Smarthphones y Masivos;                0;           1;                 0;               1;           1;S.C.                ;S.C.                ;           0;           0;          1;Terminales                                        ;HKM 6370                                          
2015-11-17;         47;HKM                                               ;Smarthphones y Masivos;                0;           1;                 0;               1;           1;S.C.                ;S.C.                ;           0;           0;          2;Terminales                                        ;HKM 6370                                          
2015-11-18;         47;HKM                                               ;Smarthphones y Masivos;                0;           1;                 0;               1;           1;S.C.                ;S.C.                ;           0;           0;          3;Terminales                                        ;HKM 6370                                          
2015-11-19;         47;HKM                                               ;Smarthphones y Masivos;                0;           1;                 0;               1;           1;S.C.                ;S.C.                ;           0;           0;          4;Terminales                                        ;HKM 6370                                          
2015-11-22;         47;HKM                                               ;Smarthphones y Masivos;                0;           1;                 0;               1;           1;S.C.                ;S.C.                ;           0;           0;          7;Terminales                                        ;HKM 6370                                          
2015-11-23;         48;HKM                                               ;Smarthphones y Masivos;                0;           1;                 0;               1;           1;S.C.                ;S.C.                ;           0;           0;          1;Terminales                                        ;HKM 6370                                          
2015-11-24;         48;HKM                                               ;Smarthphones y Masivos;                0;           1;                 0;               1;           1;S.C.                ;S.C.                ;           0;           0;          2;Terminales                                        ;HKM 6370                                          
2015-11-25;         48;HKM                                               ;Smarthphones y Masivos;                0;           1;                 0;               1;           1;S.C.                ;S.C.                ;           0;           0;          3;Terminales                                        ;HKM 6370                                          
2015-11-26;         48;HKM                                               ;Smarthphones y Masivos;                0;           1;                 0;               1;           1;S.C.                ;S.C.                ;           0;           0;          4;Terminales                                        ;HKM 6370                                          
2015-11-29;         48;HKM                                               ;Smarthphones y Masivos;                0;           1;                 0;               1;           1;S.C.                ;S.C.                ;           0;           0;          7;Terminales                                        ;HKM 6370                                          
2015-11-30;         49;HKM                                               ;Smarthphones y Masivos;                0;           1;                 0;               1;           1;S.C.                ;S.C.                ;           0;           0;          1;Terminales                                        ;HKM 6370                                          
2015-11-16;         47;HTC                                               ;iPhone y Premium      ;                4;          20;                 4;              24;          28;24,0                ;28,0                ;           1;           1;          1;Terminales                                        ;HTC ONE                                           
2015-11-17;         47;HTC                                               ;iPhone y Premium      ;                4;          20;                 4;              24;          28;48,0                ;56,0                ;           0;           1;          2;Terminales                                        ;HTC ONE                                           
2015-11-18;         47;HTC                                               ;iPhone y Premium      ;                6;          20;                 4;              24;          30;72,0                ;90,0                ;           0;           1;          3;Terminales                                        ;HTC ONE                                           
2015-11-19;         47;HTC                                               ;iPhone y Premium      ;                6;          21;                 3;              24;          30;96,0                ;120,0               ;           0;           1;          4;Terminales                                        ;HTC ONE                                           
2015-11-20;         47;HTC                                               ;iPhone y Premium      ;                0;           0;                 0;               0;           0;0,0                 ;0,0                 ;           1;           2;          5;Terminales                                        ;HTC ONE                                           
2015-11-21;         47;HTC                                               ;iPhone y Premium      ;                0;           0;                 0;               0;           0;0,0                 ;0,0                 ;           0;           2;          6;Terminales                                        ;HTC ONE                                           
2015-11-22;         47;HTC                                               ;iPhone y Premium      ;                6;          20;                 3;              23;          29;80,5                ;101,5               ;           0;           2;          7;Terminales                                        ;HTC ONE                                           
2015-11-23;         48;HTC                                               ;iPhone y Premium      ;                6;          21;                 2;              23;          29;S.C.                ;S.C.                ;           0;           0;          1;Terminales                                        ;HTC ONE                                           
2015-11-24;         48;HTC                                               ;iPhone y Premium      ;                6;          21;                 2;              23;          29;S.C.                ;S.C.                ;           0;           0;          2;Terminales                                        ;HTC ONE                                           
2015-11-25;         48;HTC                                               ;iPhone y Premium      ;                6;          23;                 0;              23;          29;S.C.                ;S.C.                ;           0;           0;          3;Terminales                                        ;HTC ONE                                           
2015-11-26;         48;HTC                                               ;iPhone y Premium      ;                6;          23;                 0;              23;          29;S.C.                ;S.C.                ;           0;           0;          4;Terminales                                        ;HTC ONE                                           
2015-11-27;         48;HTC                                               ;iPhone y Premium      ;                0;           0;                 0;               0;           0;0,0                 ;0,0                 ;           1;           1;          5;Terminales                                        ;HTC ONE                                           
2015-11-28;         48;HTC                                               ;iPhone y Premium      ;                0;           0;                 0;               0;           0;0,0                 ;0,0                 ;           0;           1;          6;Terminales                                        ;HTC ONE                                           
2015-11-29;         48;HTC                                               ;iPhone y Premium      ;                6;          22;                 0;              22;          28;154,0               ;196,0               ;           0;           1;          7;Terminales                                        ;HTC ONE                                           
2015-11-30;         49;HTC                                               ;iPhone y Premium      ;                6;          22;                 0;              22;          28;S.C.                ;S.C.                ;           0;           0;          1;Terminales                                        ;HTC ONE                                           
2015-11-16;         47;Huawei                                            ;Smarthphones y Masivos;                4;           0;                 0;               0;           4;S.C.                ;S.C.                ;           0;           0;          1;Terminales                                        ;HUA G7206                                         
2015-11-16;         47;Huawei                                            ;Smarthphones y Masivos;                1;           1;                 0;               1;           2;S.C.                ;S.C.                ;           0;           0;          1;Terminales                                        ;HUA G7300                                         
2015-11-16;         47;Huawei                                            ;Smarthphones y Masivos;             1795;           0;                 0;               0;        1795;S.C.                ;S.C.                ;           0;           0;          1;Terminales                                        ;HUA P8                                            
2015-11-16;         47;Huawei                                            ;Smarthphones y Masivos;                1;           0;                 0;               0;           1;S.C.                ;S.C.                ;           0;           0;          1;Terminales                                        ;HUA U8180                                         
2015-11-16;         47;Huawei                                            ;Smarthphones y Masivos;                0;          13;                 0;              13;          13;S.C.                ;S.C.                ;           0;           0;          1;Terminales                                        ;HUA W9120                                         
2015-11-16;         47;Huawei                                            ;Smarthphones y Masivos;                2;           5;                 1;               6;           8;S.C.                ;S.C.                ;           0;           0;          1;Terminales                                        ;HUA Y210                                          
2015-11-16;         47;Huawei                                            ;Smarthphones y Masivos;               90;         129;                 2;             131;         221;S.C.                ;S.C.                ;           0;           0;          1;Terminales                                        ;HUA Y220                                          
2015-11-16;         47;Huawei                                            ;Smarthphones y Masivos;                3;           0;                 0;               0;           3;S.C.                ;S.C.                ;           0;           0;          1;Terminales                                        ;HUA Y300                                          
2015-11-16;         47;Huawei                                            ;Smarthphones y Masivos;             4436;           0;                 0;               0;        4436;S.C.                ;S.C.                ;           0;           0;          1;Terminales                                        ;HUA Y360                                          
2015-11-16;         47;Huawei                                            ;Smarthphones y Masivos;             2532;        1416;               354;            1770;        4302;37,7                ;91,5                ;          47;          47;          1;Terminales                                        ;HUA Y365                                          
2015-11-16;         47;Huawei                                            ;Smarthphones y Masivos;              133;         173;                 1;             174;         307;174,0               ;307,0               ;           1;           1;          1;Terminales                                        ;HUA Y520                                          
2015-11-17;         47;Huawei                                            ;Smarthphones y Masivos;                4;           0;                 0;               0;           4;S.C.                ;S.C.                ;           0;           0;          2;Terminales                                        ;HUA G7206                                         
2015-11-17;         47;Huawei                                            ;Smarthphones y Masivos;                1;           1;                 0;               1;           2;S.C.                ;S.C.                ;           0;           0;          2;Terminales                                        ;HUA G7300                                         
2015-11-17;         47;Huawei                                            ;Smarthphones y Masivos;             1795;           0;                 0;               0;        1795;S.C.                ;S.C.                ;           0;           0;          2;Terminales                                        ;HUA P8                                            
2015-11-17;         47;Huawei                                            ;Smarthphones y Masivos;                1;           0;                 0;               0;           1;S.C.                ;S.C.                ;           0;           0;          2;Terminales                                        ;HUA U8180                                         
2015-11-17;         47;Huawei                                            ;Smarthphones y Masivos;                0;          13;                 0;              13;          13;S.C.                ;S.C.                ;           0;           0;          2;Terminales                                        ;HUA W9120                                         
2015-11-17;         47;Huawei                                            ;Smarthphones y Masivos;                2;           5;                 1;               6;           8;S.C.                ;S.C.                ;           0;           0;          2;Terminales                                        ;HUA Y210                                          
2015-11-17;         47;Huawei                                            ;Smarthphones y Masivos;               90;         125;                 3;             128;         218;64,0                ;109,0               ;           4;           4;          2;Terminales                                        ;HUA Y220                                          
2015-11-17;         47;Huawei                                            ;Smarthphones y Masivos;                3;           0;                 0;               0;           3;S.C.                ;S.C.                ;           0;           0;          2;Terminales                                        ;HUA Y300                                          
2015-11-17;         47;Huawei                                            ;Smarthphones y Masivos;             4011;           0;                 0;               0;        4011;S.C.                ;S.C.                ;           0;           0;          2;Terminales                                        ;HUA Y360                                          
2015-11-17;         47;Huawei                                            ;Smarthphones y Masivos;             2502;        1438;               326;            1764;        4266;48,3                ;116,9               ;          26;          73;          2;Terminales                                        ;HUA Y365                                          
2015-11-17;         47;Huawei                                            ;Smarthphones y Masivos;              133;         173;                 1;             174;         307;348,0               ;614,0               ;           0;           1;          2;Terminales                                        ;HUA Y520                                          
2015-11-18;         47;Huawei                                            ;Smarthphones y Masivos;                4;           0;                 0;               0;           4;S.C.                ;S.C.                ;           0;           0;          3;Terminales                                        ;HUA G7206                                         
2015-11-18;         47;Huawei                                            ;Smarthphones y Masivos;                1;           1;                 0;               1;           2;S.C.                ;S.C.                ;           0;           0;          3;Terminales                                        ;HUA G7300                                         
2015-11-18;         47;Huawei                                            ;Smarthphones y Masivos;             1795;           0;                 0;               0;        1795;S.C.                ;S.C.                ;           0;           0;          3;Terminales                                        ;HUA P8                                            
2015-11-18;         47;Huawei                                            ;Smarthphones y Masivos;                1;           0;                 0;               0;           1;S.C.                ;S.C.                ;           0;           0;          3;Terminales                                        ;HUA U8180                                         
2015-11-18;         47;Huawei                                            ;Smarthphones y Masivos;                0;          13;                 0;              13;          13;S.C.                ;S.C.                ;           0;           0;          3;Terminales                                        ;HUA W9120                                         
2015-11-18;         47;Huawei                                            ;Smarthphones y Masivos;                2;           5;                 1;               6;           8;S.C.                ;S.C.                ;           0;           0;          3;Terminales                                        ;HUA Y210                                          
2015-11-18;         47;Huawei                                            ;Smarthphones y Masivos;               96;         127;                 3;             130;         226;97,5                ;169,5               ;           0;           4;          3;Terminales                                        ;HUA Y220                                          
2015-11-18;         47;Huawei                                            ;Smarthphones y Masivos;                3;           0;                 0;               0;           3;S.C.                ;S.C.                ;           0;           0;          3;Terminales                                        ;HUA Y300                                          
2015-11-18;         47;Huawei                                            ;Smarthphones y Masivos;             3886;           0;                 0;               0;        3886;S.C.                ;S.C.                ;           0;           0;          3;Terminales                                        ;HUA Y360                                          
2015-11-18;         47;Huawei                                            ;Smarthphones y Masivos;             2482;        1411;               341;            1752;        4234;55,3                ;133,7               ;          22;          95;          3;Terminales                                        ;HUA Y365                                          
2015-11-18;         47;Huawei                                            ;Smarthphones y Masivos;              144;         173;                 1;             174;         318;522,0               ;954,0               ;           0;           1;          3;Terminales                                        ;HUA Y520                                          
2015-11-19;         47;Huawei                                            ;Smarthphones y Masivos;                4;           0;                 0;               0;           4;S.C.                ;S.C.                ;           0;           0;          4;Terminales                                        ;HUA G7206                                         
2015-11-19;         47;Huawei                                            ;Smarthphones y Masivos;                1;           1;                 0;               1;           2;S.C.                ;S.C.                ;           0;           0;          4;Terminales                                        ;HUA G7300                                         
2015-11-19;         47;Huawei                                            ;Smarthphones y Masivos;             1966;           0;                 0;               0;        1966;S.C.                ;S.C.                ;           0;           0;          4;Terminales                                        ;HUA P8                                            
2015-11-19;         47;Huawei                                            ;Smarthphones y Masivos;                1;           0;                 0;               0;           1;S.C.                ;S.C.                ;           0;           0;          4;Terminales                                        ;HUA U8180                                         
2015-11-19;         47;Huawei                                            ;Smarthphones y Masivos;                0;          13;                 0;              13;          13;S.C.                ;S.C.                ;           0;           0;          4;Terminales                                        ;HUA W9120                                         
2015-11-19;         47;Huawei                                            ;Smarthphones y Masivos;                2;           5;                 1;               6;           8;S.C.                ;S.C.                ;           0;           0;          4;Terminales                                        ;HUA Y210                                          
2015-11-19;         47;Huawei                                            ;Smarthphones y Masivos;               96;         128;                 2;             130;         226;130,0               ;226,0               ;           0;           4;          4;Terminales                                        ;HUA Y220                                          
2015-11-19;         47;Huawei                                            ;Smarthphones y Masivos;                3;           0;                 0;               0;           3;S.C.                ;S.C.                ;           0;           0;          4;Terminales                                        ;HUA Y300                                          
2015-11-19;         47;Huawei                                            ;Smarthphones y Masivos;             3063;           0;                 0;               0;        3063;S.C.                ;S.C.                ;           0;           0;          4;Terminales                                        ;HUA Y360                                          
2015-11-19;         47;Huawei                                            ;Smarthphones y Masivos;             2446;        1646;               115;            1761;        4207;64,6                ;154,4               ;          14;         109;          4;Terminales                                        ;HUA Y365                                          
2015-11-19;         47;Huawei                                            ;Smarthphones y Masivos;              144;         169;                 1;             170;         314;170,0               ;314,0               ;           3;           4;          4;Terminales                                        ;HUA Y520                                          
2015-11-20;         47;Huawei                                            ;Smarthphones y Masivos;                0;           0;                 0;               0;           0;0,0                 ;0,0                 ;           3;           7;          5;Terminales                                        ;HUA Y220                                          
2015-11-20;         47;Huawei                                            ;Smarthphones y Masivos;                0;           0;                 0;               0;           0;0,0                 ;0,0                 ;          81;         190;          5;Terminales                                        ;HUA Y365                                          
2015-11-20;         47;Huawei                                            ;Smarthphones y Masivos;                0;           0;                 0;               0;           0;0,0                 ;0,0                 ;           0;           4;          5;Terminales                                        ;HUA Y520                                          
2015-11-21;         47;Huawei                                            ;Smarthphones y Masivos;                0;           0;                 0;               0;           0;0,0                 ;0,0                 ;           1;           8;          6;Terminales                                        ;HUA Y220                                          
2015-11-21;         47;Huawei                                            ;Smarthphones y Masivos;                0;           0;                 0;               0;           0;0,0                 ;0,0                 ;           6;         196;          6;Terminales                                        ;HUA Y365                                          
2015-11-21;         47;Huawei                                            ;Smarthphones y Masivos;                0;           0;                 0;               0;           0;0,0                 ;0,0                 ;           1;           5;          6;Terminales                                        ;HUA Y520                                          
2015-11-22;         47;Huawei                                            ;Smarthphones y Masivos;                4;           0;                 0;               0;           4;S.C.                ;S.C.                ;           0;           0;          7;Terminales                                        ;HUA G7206                                         
2015-11-22;         47;Huawei                                            ;Smarthphones y Masivos;                1;           1;                 0;               1;           2;S.C.                ;S.C.                ;           0;           0;          7;Terminales                                        ;HUA G7300                                         
2015-11-22;         47;Huawei                                            ;Smarthphones y Masivos;              981;           0;               985;             985;        1966;S.C.                ;S.C.                ;           0;           0;          7;Terminales                                        ;HUA P8                                            
2015-11-22;         47;Huawei                                            ;Smarthphones y Masivos;                1;           0;                 0;               0;           1;S.C.                ;S.C.                ;           0;           0;          7;Terminales                                        ;HUA U8180                                         
2015-11-22;         47;Huawei                                            ;Smarthphones y Masivos;                0;          13;                 0;              13;          13;S.C.                ;S.C.                ;           0;           0;          7;Terminales                                        ;HUA W9120                                         
2015-11-22;         47;Huawei                                            ;Smarthphones y Masivos;                2;           5;                 1;               6;           8;S.C.                ;S.C.                ;           0;           0;          7;Terminales                                        ;HUA Y210                                          
2015-11-22;         47;Huawei                                            ;Smarthphones y Masivos;               96;         124;                 2;             126;         222;110,3               ;194,3               ;           0;           8;          7;Terminales                                        ;HUA Y220                                          
2015-11-22;         47;Huawei                                            ;Smarthphones y Masivos;                3;           0;                 0;               0;           3;S.C.                ;S.C.                ;           0;           0;          7;Terminales                                        ;HUA Y300                                          
2015-11-22;         47;Huawei                                            ;Smarthphones y Masivos;             3135;           0;                 0;               0;        3135;S.C.                ;S.C.                ;           0;           0;          7;Terminales                                        ;HUA Y360                                          
2015-11-22;         47;Huawei                                            ;Smarthphones y Masivos;             2428;        1593;                97;            1690;        4118;60,1                ;146,3               ;           1;         197;          7;Terminales                                        ;HUA Y365                                          
2015-11-22;         47;Huawei                                            ;Smarthphones y Masivos;              144;         165;                 3;             168;         312;235,2               ;436,8               ;           0;           5;          7;Terminales                                        ;HUA Y520                                          
2015-11-23;         48;Huawei                                            ;Smarthphones y Masivos;                4;           0;                 0;               0;           4;S.C.                ;S.C.                ;           0;           0;          1;Terminales                                        ;HUA G7206                                         
2015-11-23;         48;Huawei                                            ;Smarthphones y Masivos;                1;           1;                 0;               1;           2;S.C.                ;S.C.                ;           0;           0;          1;Terminales                                        ;HUA G7300                                         
2015-11-23;         48;Huawei                                            ;Smarthphones y Masivos;              937;         454;               569;            1023;        1960;255,8               ;490,0               ;           4;           4;          1;Terminales                                        ;HUA P8                                            
2015-11-23;         48;Huawei                                            ;Smarthphones y Masivos;                1;           0;                 0;               0;           1;S.C.                ;S.C.                ;           0;           0;          1;Terminales                                        ;HUA U8180                                         
2015-11-23;         48;Huawei                                            ;Smarthphones y Masivos;                0;          13;                 0;              13;          13;S.C.                ;S.C.                ;           0;           0;          1;Terminales                                        ;HUA W9120                                         
2015-11-23;         48;Huawei                                            ;Smarthphones y Masivos;                2;           5;                 1;               6;           8;S.C.                ;S.C.                ;           0;           0;          1;Terminales                                        ;HUA Y210                                          
2015-11-23;         48;Huawei                                            ;Smarthphones y Masivos;              107;         123;                 2;             125;         232;125,0               ;232,0               ;           1;           1;          1;Terminales                                        ;HUA Y220                                          
2015-11-23;         48;Huawei                                            ;Smarthphones y Masivos;                3;           0;                 0;               0;           3;S.C.                ;S.C.                ;           0;           0;          1;Terminales                                        ;HUA Y300                                          
2015-11-23;         48;Huawei                                            ;Smarthphones y Masivos;             3075;           0;                 0;               0;        3075;S.C.                ;S.C.                ;           0;           0;          1;Terminales                                        ;HUA Y360                                          
2015-11-23;         48;Huawei                                            ;Smarthphones y Masivos;             2103;        1572;               407;            1979;        4082;58,2                ;120,1               ;          34;          34;          1;Terminales                                        ;HUA Y365                                          
2015-11-23;         48;Huawei                                            ;Smarthphones y Masivos;              174;         165;                 3;             168;         342;S.C.                ;S.C.                ;           0;           0;          1;Terminales                                        ;HUA Y520                                          
2015-11-24;         48;Huawei                                            ;Smarthphones y Masivos;                4;           0;                 0;               0;           4;S.C.                ;S.C.                ;           0;           0;          2;Terminales                                        ;HUA G7206                                         
2015-11-24;         48;Huawei                                            ;Smarthphones y Masivos;                1;           1;                 0;               1;           2;S.C.                ;S.C.                ;           0;           0;          2;Terminales                                        ;HUA G7300                                         
2015-11-24;         48;Huawei                                            ;Smarthphones y Masivos;              935;         874;               121;             995;        1930;62,2                ;120,6               ;          28;          32;          2;Terminales                                        ;HUA P8                                            
2015-11-24;         48;Huawei                                            ;Smarthphones y Masivos;                1;           0;                 0;               0;           1;S.C.                ;S.C.                ;           0;           0;          2;Terminales                                        ;HUA U8180                                         
2015-11-24;         48;Huawei                                            ;Smarthphones y Masivos;                0;          13;                 0;              13;          13;S.C.                ;S.C.                ;           0;           0;          2;Terminales                                        ;HUA W9120                                         
2015-11-24;         48;Huawei                                            ;Smarthphones y Masivos;                2;           5;                 1;               6;           8;S.C.                ;S.C.                ;           0;           0;          2;Terminales                                        ;HUA Y210                                          
2015-11-24;         48;Huawei                                            ;Smarthphones y Masivos;              107;         126;                 1;             127;         234;-254,0              ;-468,0              ;          -2;          -1;          2;Terminales                                        ;HUA Y220                                          
2015-11-24;         48;Huawei                                            ;Smarthphones y Masivos;                3;           0;                 0;               0;           3;S.C.                ;S.C.                ;           0;           0;          2;Terminales                                        ;HUA Y300                                          
2015-11-24;         48;Huawei                                            ;Smarthphones y Masivos;             2145;           0;                 0;               0;        2145;S.C.                ;S.C.                ;           0;           0;          2;Terminales                                        ;HUA Y360                                          
2015-11-24;         48;Huawei                                            ;Smarthphones y Masivos;             2099;        1632;               323;            1955;        4054;66,3                ;137,4               ;          25;          59;          2;Terminales                                        ;HUA Y365                                          
2015-11-24;         48;Huawei                                            ;Smarthphones y Masivos;              174;         169;                 3;             172;         346;S.C.                ;S.C.                ;           0;           0;          2;Terminales                                        ;HUA Y520                                          
2015-11-25;         48;Huawei                                            ;Smarthphones y Masivos;                4;           0;                 0;               0;           4;S.C.                ;S.C.                ;           0;           0;          3;Terminales                                        ;HUA G7206                                         
2015-11-25;         48;Huawei                                            ;Smarthphones y Masivos;                1;           1;                 0;               1;           2;S.C.                ;S.C.                ;           0;           0;          3;Terminales                                        ;HUA G7300                                         
2015-11-25;         48;Huawei                                            ;Smarthphones y Masivos;              635;         854;               379;            1233;        1868;39,4                ;59,6                ;          62;          94;          3;Terminales                                        ;HUA P8                                            
2015-11-25;         48;Huawei                                            ;Smarthphones y Masivos;                1;           0;                 0;               0;           1;S.C.                ;S.C.                ;           0;           0;          3;Terminales                                        ;HUA U8180                                         
2015-11-25;         48;Huawei                                            ;Smarthphones y Masivos;                0;          13;                 0;              13;          13;S.C.                ;S.C.                ;           0;           0;          3;Terminales                                        ;HUA W9120                                         
2015-11-25;         48;Huawei                                            ;Smarthphones y Masivos;                2;           6;                 0;               6;           8;S.C.                ;S.C.                ;           0;           0;          3;Terminales                                        ;HUA Y210                                          
2015-11-25;         48;Huawei                                            ;Smarthphones y Masivos;              107;         126;                 1;             127;         234;-381,0              ;-702,0              ;           0;          -1;          3;Terminales                                        ;HUA Y220                                          
2015-11-25;         48;Huawei                                            ;Smarthphones y Masivos;                3;           0;                 0;               0;           3;S.C.                ;S.C.                ;           0;           0;          3;Terminales                                        ;HUA Y300                                          
2015-11-25;         48;Huawei                                            ;Smarthphones y Masivos;             1834;           0;                 0;               0;        1834;S.C.                ;S.C.                ;           0;           0;          3;Terminales                                        ;HUA Y360                                          
2015-11-25;         48;Huawei                                            ;Smarthphones y Masivos;             2091;        1842;                89;            1931;        4022;67,4                ;140,3               ;          27;          86;          3;Terminales                                        ;HUA Y365                                          
2015-11-25;         48;Huawei                                            ;Smarthphones y Masivos;              174;         168;                 3;             171;         345;S.C.                ;S.C.                ;           0;           0;          3;Terminales                                        ;HUA Y520                                          
2015-11-26;         48;Huawei                                            ;Smarthphones y Masivos;                4;           0;                 0;               0;           4;S.C.                ;S.C.                ;           0;           0;          4;Terminales                                        ;HUA G7206                                         
2015-11-26;         48;Huawei                                            ;Smarthphones y Masivos;                1;           1;                 0;               1;           2;S.C.                ;S.C.                ;           0;           0;          4;Terminales                                        ;HUA G7300                                         
2015-11-26;         48;Huawei                                            ;Smarthphones y Masivos;              677;         817;               300;            1117;        1794;26,8                ;43,0                ;          73;         167;          4;Terminales                                        ;HUA P8                                            
2015-11-26;         48;Huawei                                            ;Smarthphones y Masivos;                1;           0;                 0;               0;           1;S.C.                ;S.C.                ;           0;           0;          4;Terminales                                        ;HUA U8180                                         
2015-11-26;         48;Huawei                                            ;Smarthphones y Masivos;                0;          13;                 0;              13;          13;S.C.                ;S.C.                ;           0;           0;          4;Terminales                                        ;HUA W9120                                         
2015-11-26;         48;Huawei                                            ;Smarthphones y Masivos;                2;           6;                 0;               6;           8;S.C.                ;S.C.                ;           0;           0;          4;Terminales                                        ;HUA Y210                                          
2015-11-26;         48;Huawei                                            ;Smarthphones y Masivos;              107;         122;                 1;             123;         230;123,0               ;230,0               ;           5;           4;          4;Terminales                                        ;HUA Y220                                          
2015-11-26;         48;Huawei                                            ;Smarthphones y Masivos;                3;           0;                 0;               0;           3;S.C.                ;S.C.                ;           0;           0;          4;Terminales                                        ;HUA Y300                                          
2015-11-26;         48;Huawei                                            ;Smarthphones y Masivos;             1834;           0;                 0;               0;        1834;S.C.                ;S.C.                ;           0;           0;          4;Terminales                                        ;HUA Y360                                          
2015-11-26;         48;Huawei                                            ;Smarthphones y Masivos;             2082;        1832;                77;            1909;        3991;67,6                ;141,3               ;          27;         113;          4;Terminales                                        ;HUA Y365                                          
2015-11-26;         48;Huawei                                            ;Smarthphones y Masivos;              174;         168;                 3;             171;         345;S.C.                ;S.C.                ;           0;           0;          4;Terminales                                        ;HUA Y520                                          
2015-11-27;         48;Huawei                                            ;Smarthphones y Masivos;                0;           0;                 0;               0;           0;0,0                 ;0,0                 ;          84;         251;          5;Terminales                                        ;HUA P8                                            
2015-11-27;         48;Huawei                                            ;Smarthphones y Masivos;                0;           0;                 0;               0;           0;0,0                 ;0,0                 ;           3;           7;          5;Terminales                                        ;HUA Y220                                          
2015-11-27;         48;Huawei                                            ;Smarthphones y Masivos;                0;           0;                 0;               0;           0;0,0                 ;0,0                 ;          30;         143;          5;Terminales                                        ;HUA Y365                                          
2015-11-28;         48;Huawei                                            ;Smarthphones y Masivos;                0;           0;                 0;               0;           0;0,0                 ;0,0                 ;           1;         252;          6;Terminales                                        ;HUA P8                                            
2015-11-28;         48;Huawei                                            ;Smarthphones y Masivos;                0;           0;                 0;               0;           0;0,0                 ;0,0                 ;           0;           7;          6;Terminales                                        ;HUA Y220                                          
2015-11-28;         48;Huawei                                            ;Smarthphones y Masivos;                0;           0;                 0;               0;           0;0,0                 ;0,0                 ;           5;         148;          6;Terminales                                        ;HUA Y365                                          
2015-11-29;         48;Huawei                                            ;Smarthphones y Masivos;                4;           0;                 0;               0;           4;S.C.                ;S.C.                ;           0;           0;          7;Terminales                                        ;HUA G7206                                         
2015-11-29;         48;Huawei                                            ;Smarthphones y Masivos;                1;           1;                 0;               1;           2;S.C.                ;S.C.                ;           0;           0;          7;Terminales                                        ;HUA G7300                                         
2015-11-29;         48;Huawei                                            ;Smarthphones y Masivos;              677;         730;               300;            1030;        1707;28,6                ;47,4                ;           0;         252;          7;Terminales                                        ;HUA P8                                            
2015-11-29;         48;Huawei                                            ;Smarthphones y Masivos;                1;           0;                 0;               0;           1;S.C.                ;S.C.                ;           0;           0;          7;Terminales                                        ;HUA U8180                                         
2015-11-29;         48;Huawei                                            ;Smarthphones y Masivos;                0;          13;                 0;              13;          13;S.C.                ;S.C.                ;           0;           0;          7;Terminales                                        ;HUA W9120                                         
2015-11-29;         48;Huawei                                            ;Smarthphones y Masivos;                2;           6;                 0;               6;           8;S.C.                ;S.C.                ;           0;           0;          7;Terminales                                        ;HUA Y210                                          
2015-11-29;         48;Huawei                                            ;Smarthphones y Masivos;              108;         121;                 1;             122;         230;122,0               ;230,0               ;           0;           7;          7;Terminales                                        ;HUA Y220                                          
2015-11-29;         48;Huawei                                            ;Smarthphones y Masivos;                3;           0;                 0;               0;           3;S.C.                ;S.C.                ;           0;           0;          7;Terminales                                        ;HUA Y300                                          
2015-11-29;         48;Huawei                                            ;Smarthphones y Masivos;             1092;           0;                 0;               0;        1092;S.C.                ;S.C.                ;           0;           0;          7;Terminales                                        ;HUA Y360                                          
2015-11-29;         48;Huawei                                            ;Smarthphones y Masivos;             2036;        1818;               113;            1931;        3967;90,7                ;186,4               ;           1;         149;          7;Terminales                                        ;HUA Y365                                          
2015-11-29;         48;Huawei                                            ;Smarthphones y Masivos;              186;         168;                 3;             171;         357;S.C.                ;S.C.                ;           0;           0;          7;Terminales                                        ;HUA Y520                                          
2015-11-30;         49;Huawei                                            ;Smarthphones y Masivos;                4;           0;                 0;               0;           4;S.C.                ;S.C.                ;           0;           0;          1;Terminales                                        ;HUA G7206                                         
2015-11-30;         49;Huawei                                            ;Smarthphones y Masivos;                1;           1;                 0;               1;           2;S.C.                ;S.C.                ;           0;           0;          1;Terminales                                        ;HUA G7300                                         
2015-11-30;         49;Huawei                                            ;Smarthphones y Masivos;              677;         651;               300;             951;        1628;12,2                ;20,9                ;          78;          78;          1;Terminales                                        ;HUA P8                                            
2015-11-30;         49;Huawei                                            ;Smarthphones y Masivos;                1;           0;                 0;               0;           1;S.C.                ;S.C.                ;           0;           0;          1;Terminales                                        ;HUA U8180                                         
2015-11-30;         49;Huawei                                            ;Smarthphones y Masivos;                0;          13;                 0;              13;          13;S.C.                ;S.C.                ;           0;           0;          1;Terminales                                        ;HUA W9120                                         
2015-11-30;         49;Huawei                                            ;Smarthphones y Masivos;                2;           6;                 0;               6;           8;S.C.                ;S.C.                ;           0;           0;          1;Terminales                                        ;HUA Y210                                          
2015-11-30;         49;Huawei                                            ;Smarthphones y Masivos;              108;         119;                 1;             120;         228;60,0                ;114,0               ;           2;           2;          1;Terminales                                        ;HUA Y220                                          
2015-11-30;         49;Huawei                                            ;Smarthphones y Masivos;                3;           0;                 0;               0;           3;S.C.                ;S.C.                ;           0;           0;          1;Terminales                                        ;HUA Y300                                          
2015-11-30;         49;Huawei                                            ;Smarthphones y Masivos;              758;           0;                 0;               0;         758;S.C.                ;S.C.                ;           0;           0;          1;Terminales                                        ;HUA Y360                                          
2015-11-30;         49;Huawei                                            ;Smarthphones y Masivos;             1855;        1960;               118;            2078;        3933;115,4               ;218,5               ;          18;          18;          1;Terminales                                        ;HUA Y365                                          
2015-11-30;         49;Huawei                                            ;Smarthphones y Masivos;              186;         166;                 3;             169;         355;169,0               ;355,0               ;           1;           1;          1;Terminales                                        ;HUA Y520                                          
2015-11-16;         47;LG                                                ;iPhone y Premium      ;               50;          14;                 2;              16;          66;S.C.                ;S.C.                ;           0;           0;          1;Terminales                                        ;Lg G Flex (D956)                                  
2015-11-16;         47;LG                                                ;iPhone y Premium      ;               31;          94;                 3;              97;         128;S.C.                ;S.C.                ;           0;           0;          1;Terminales                                        ;Lg G2                                             
2015-11-16;         47;LG                                                ;iPhone y Premium      ;               41;         163;                 0;             163;         204;S.C.                ;S.C.                ;           0;           0;          1;Terminales                                        ;Lg G3 (D855)                                      
2015-11-16;         47;LG                                                ;iPhone y Premium      ;              207;         447;                 2;             449;         656;44,9                ;65,6                ;          10;          10;          1;Terminales                                        ;Lg G4                                             
2015-11-16;         47;LG                                                ;Smarthphones y Masivos;               53;           0;                 0;               0;          53;S.C.                ;S.C.                ;           0;           0;          1;Terminales                                        ;Lg A1-A270                                        
2015-11-16;         47;LG                                                ;Smarthphones y Masivos;                1;           0;                 0;               0;           1;S.C.                ;S.C.                ;           0;           0;          1;Terminales                                        ;Lg C195                                           
2015-11-16;         47;LG                                                ;Smarthphones y Masivos;                2;          59;                 1;              60;          62;S.C.                ;S.C.                ;           0;           0;          1;Terminales                                        ;Lg C365                                           
2015-11-16;         47;LG                                                ;Smarthphones y Masivos;              184;         436;                 3;             439;         623;S.C.                ;S.C.                ;           0;           0;          1;Terminales                                        ;Lg G2 Mini                                        
2015-11-16;         47;LG                                                ;Smarthphones y Masivos;               56;         619;                18;             637;         693;127,4               ;138,6               ;           5;           5;          1;Terminales                                        ;Lg G3 Beat                                        
2015-11-16;         47;LG                                                ;Smarthphones y Masivos;                0;           1;                 0;               1;           1;S.C.                ;S.C.                ;           0;           0;          1;Terminales                                        ;Lg KP570                                          
2015-11-16;         47;LG                                                ;Smarthphones y Masivos;                4;           0;                 0;               0;           4;S.C.                ;S.C.                ;           0;           0;          1;Terminales                                        ;Lg L Lift                                         
2015-11-16;         47;LG                                                ;Smarthphones y Masivos;                2;          30;                 0;              30;          32;S.C.                ;S.C.                ;           0;           0;          1;Terminales                                        ;Lg L20                                            
2015-11-16;         47;LG                                                ;Smarthphones y Masivos;                2;           1;                 0;               1;           3;S.C.                ;S.C.                ;           0;           0;          1;Terminales                                        ;Lg L3                                             
2015-11-16;         47;LG                                                ;Smarthphones y Masivos;                1;           0;                 0;               0;           1;S.C.                ;S.C.                ;           0;           0;          1;Terminales                                        ;Lg L3 II                                          
2015-11-16;         47;LG                                                ;Smarthphones y Masivos;              177;         145;                 1;             146;         323;146,0               ;323,0               ;           1;           1;          1;Terminales                                        ;Lg L40                                            
2015-11-16;         47;LG                                                ;Smarthphones y Masivos;                0;           8;                 0;               8;           8;S.C.                ;S.C.                ;           0;           0;          1;Terminales                                        ;Lg L5                                             
2015-11-16;         47;LG                                                ;Smarthphones y Masivos;              350;          46;                 1;              47;         397;S.C.                ;S.C.                ;           0;           0;          1;Terminales                                        ;Lg L5 II                                          
2015-11-16;         47;LG                                                ;Smarthphones y Masivos;                4;           2;                 0;               2;           6;S.C.                ;S.C.                ;           0;           0;          1;Terminales                                        ;Lg L50                                            
2015-11-16;         47;LG                                                ;Smarthphones y Masivos;               12;          10;                 4;              14;          26;S.C.                ;S.C.                ;           0;           0;          1;Terminales                                        ;Lg L7                                             
2015-11-16;         47;LG                                                ;Smarthphones y Masivos;              359;         149;                 7;             156;         515;S.C.                ;S.C.                ;           0;           0;          1;Terminales                                        ;Lg L70                                            
2015-11-16;         47;LG                                                ;Smarthphones y Masivos;                0;           6;                 1;               7;           7;S.C.                ;S.C.                ;           0;           0;          1;Terminales                                        ;Lg L9                                             
2015-11-16;         47;LG                                                ;Smarthphones y Masivos;             1377;        1195;                19;            1214;        2591;43,4                ;92,5                ;          28;          28;          1;Terminales                                        ;Lg Magna                                          
2015-11-16;         47;LG                                                ;Smarthphones y Masivos;                0;           2;                 0;               2;           2;S.C.                ;S.C.                ;           0;           0;          1;Terminales                                        ;Lg Optimus Live                                   
2015-11-16;         47;LG                                                ;Smarthphones y Masivos;                0;           1;                 0;               1;           1;S.C.                ;S.C.                ;           0;           0;          1;Terminales                                        ;Lg Optimus Pro                                    
2015-11-16;         47;LG                                                ;Smarthphones y Masivos;                1;           0;                 0;               0;           1;S.C.                ;S.C.                ;           0;           0;          1;Terminales                                        ;Lg P350                                           
2015-11-16;         47;LG                                                ;Smarthphones y Masivos;                0;           2;                 0;               2;           2;S.C.                ;S.C.                ;           0;           0;          1;Terminales                                        ;LG P500                                           
2015-11-16;         47;LG                                                ;Smarthphones y Masivos;                1;           0;                 0;               0;           1;S.C.                ;S.C.                ;           0;           0;          1;Terminales                                        ;Lg T3                                             
2015-11-16;         47;LG                                                ;Smarthphones y Masivos;                2;           0;                 0;               0;           2;S.C.                ;S.C.                ;           0;           0;          1;Terminales                                        ;Lg T300                                           
2015-11-17;         47;LG                                                ;iPhone y Premium      ;               50;          14;                 2;              16;          66;S.C.                ;S.C.                ;           0;           0;          2;Terminales                                        ;Lg G Flex (D956)                                  
2015-11-17;         47;LG                                                ;iPhone y Premium      ;               31;          94;                 3;              97;         128;194,0               ;256,0               ;           1;           1;          2;Terminales                                        ;Lg G2                                             
2015-11-17;         47;LG                                                ;iPhone y Premium      ;               41;         155;                 0;             155;         196;S.C.                ;S.C.                ;           0;           0;          2;Terminales                                        ;Lg G3 (D855)                                      
2015-11-17;         47;LG                                                ;iPhone y Premium      ;               70;         434;               138;             572;         642;47,7                ;53,5                ;          14;          24;          2;Terminales                                        ;Lg G4                                             
2015-11-17;         47;LG                                                ;Smarthphones y Masivos;               53;           0;                 0;               0;          53;S.C.                ;S.C.                ;           0;           0;          2;Terminales                                        ;Lg A1-A270                                        
2015-11-17;         47;LG                                                ;Smarthphones y Masivos;                1;           0;                 0;               0;           1;S.C.                ;S.C.                ;           0;           0;          2;Terminales                                        ;Lg C195                                           
2015-11-17;         47;LG                                                ;Smarthphones y Masivos;                2;          59;                 1;              60;          62;S.C.                ;S.C.                ;           0;           0;          2;Terminales                                        ;Lg C365                                           
2015-11-17;         47;LG                                                ;Smarthphones y Masivos;              184;         431;                 3;             434;         618;217,0               ;309,0               ;           4;           4;          2;Terminales                                        ;Lg G2 Mini                                        
2015-11-17;         47;LG                                                ;Smarthphones y Masivos;               47;         611;                27;             638;         685;127,6               ;137,0               ;           5;          10;          2;Terminales                                        ;Lg G3 Beat                                        
2015-11-17;         47;LG                                                ;Smarthphones y Masivos;                0;           1;                 0;               1;           1;S.C.                ;S.C.                ;           0;           0;          2;Terminales                                        ;Lg KP570                                          
2015-11-17;         47;LG                                                ;Smarthphones y Masivos;                4;           0;                 0;               0;           4;S.C.                ;S.C.                ;           0;           0;          2;Terminales                                        ;Lg L Lift                                         
2015-11-17;         47;LG                                                ;Smarthphones y Masivos;                2;          30;                 0;              30;          32;S.C.                ;S.C.                ;           0;           0;          2;Terminales                                        ;Lg L20                                            
2015-11-17;         47;LG                                                ;Smarthphones y Masivos;                2;           1;                 0;               1;           3;S.C.                ;S.C.                ;           0;           0;          2;Terminales                                        ;Lg L3                                             
2015-11-17;         47;LG                                                ;Smarthphones y Masivos;                1;           0;                 0;               0;           1;S.C.                ;S.C.                ;           0;           0;          2;Terminales                                        ;Lg L3 II                                          
2015-11-17;         47;LG                                                ;Smarthphones y Masivos;              177;         139;                 1;             140;         317;70,0                ;158,5               ;           3;           4;          2;Terminales                                        ;Lg L40                                            
2015-11-17;         47;LG                                                ;Smarthphones y Masivos;                0;           8;                 0;               8;           8;S.C.                ;S.C.                ;           0;           0;          2;Terminales                                        ;Lg L5                                             
2015-11-17;         47;LG                                                ;Smarthphones y Masivos;              350;          41;                 1;              42;         392;S.C.                ;S.C.                ;           0;           0;          2;Terminales                                        ;Lg L5 II                                          
2015-11-17;         47;LG                                                ;Smarthphones y Masivos;                4;           2;                 0;               2;           6;S.C.                ;S.C.                ;           0;           0;          2;Terminales                                        ;Lg L50                                            
2015-11-17;         47;LG                                                ;Smarthphones y Masivos;               12;           7;                 4;              11;          23;S.C.                ;S.C.                ;           0;           0;          2;Terminales                                        ;Lg L7                                             
2015-11-17;         47;LG                                                ;Smarthphones y Masivos;              359;         156;                 0;             156;         515;S.C.                ;S.C.                ;           0;           0;          2;Terminales                                        ;Lg L70                                            
2015-11-17;         47;LG                                                ;Smarthphones y Masivos;                0;           6;                 1;               7;           7;S.C.                ;S.C.                ;           0;           0;          2;Terminales                                        ;Lg L9                                             
2015-11-17;         47;LG                                                ;Smarthphones y Masivos;             1319;        1149;                77;            1226;        2545;31,8                ;66,1                ;          49;          77;          2;Terminales                                        ;Lg Magna                                          
2015-11-17;         47;LG                                                ;Smarthphones y Masivos;                0;           2;                 0;               2;           2;S.C.                ;S.C.                ;           0;           0;          2;Terminales                                        ;Lg Optimus Live                                   
2015-11-17;         47;LG                                                ;Smarthphones y Masivos;                0;           1;                 0;               1;           1;S.C.                ;S.C.                ;           0;           0;          2;Terminales                                        ;Lg Optimus Pro                                    
2015-11-17;         47;LG                                                ;Smarthphones y Masivos;                1;           0;                 0;               0;           1;S.C.                ;S.C.                ;           0;           0;          2;Terminales                                        ;Lg P350                                           
2015-11-17;         47;LG                                                ;Smarthphones y Masivos;                0;           2;                 0;               2;           2;S.C.                ;S.C.                ;           0;           0;          2;Terminales                                        ;LG P500                                           
2015-11-17;         47;LG                                                ;Smarthphones y Masivos;                1;           0;                 0;               0;           1;S.C.                ;S.C.                ;           0;           0;          2;Terminales                                        ;Lg T3                                             
2015-11-17;         47;LG                                                ;Smarthphones y Masivos;                2;           0;                 0;               0;           2;S.C.                ;S.C.                ;           0;           0;          2;Terminales                                        ;Lg T300                                           
2015-11-18;         47;LG                                                ;iPhone y Premium      ;               53;          14;                 2;              16;          69;S.C.                ;S.C.                ;           0;           0;          3;Terminales                                        ;Lg G Flex (D956)                                  
2015-11-18;         47;LG                                                ;iPhone y Premium      ;               36;          94;                 3;              97;         133;291,0               ;399,0               ;           0;           1;          3;Terminales                                        ;Lg G2                                             
2015-11-18;         47;LG                                                ;iPhone y Premium      ;               47;         155;                 0;             155;         202;S.C.                ;S.C.                ;           0;           0;          3;Terminales                                        ;Lg G3 (D855)                                      
2015-11-18;         47;LG                                                ;iPhone y Premium      ;               71;         424;               138;             562;         633;52,7                ;59,3                ;           8;          32;          3;Terminales                                        ;Lg G4                                             
2015-11-18;         47;LG                                                ;Smarthphones y Masivos;               53;           0;                 0;               0;          53;S.C.                ;S.C.                ;           0;           0;          3;Terminales                                        ;Lg A1-A270                                        
2015-11-18;         47;LG                                                ;Smarthphones y Masivos;                1;           0;                 0;               0;           1;S.C.                ;S.C.                ;           0;           0;          3;Terminales                                        ;Lg C195                                           
2015-11-18;         47;LG                                                ;Smarthphones y Masivos;                2;          59;                 1;              60;          62;S.C.                ;S.C.                ;           0;           0;          3;Terminales                                        ;Lg C365                                           
2015-11-18;         47;LG                                                ;Smarthphones y Masivos;              202;         433;                 3;             436;         638;261,6               ;382,8               ;           1;           5;          3;Terminales                                        ;Lg G2 Mini                                        
2015-11-18;         47;LG                                                ;Smarthphones y Masivos;               61;         614;                14;             628;         689;110,8               ;121,6               ;           7;          17;          3;Terminales                                        ;Lg G3 Beat                                        
2015-11-18;         47;LG                                                ;Smarthphones y Masivos;                0;           1;                 0;               1;           1;S.C.                ;S.C.                ;           0;           0;          3;Terminales                                        ;Lg KP570                                          
2015-11-18;         47;LG                                                ;Smarthphones y Masivos;                4;           0;                 0;               0;           4;S.C.                ;S.C.                ;           0;           0;          3;Terminales                                        ;Lg L Lift                                         
2015-11-18;         47;LG                                                ;Smarthphones y Masivos;                2;          30;                 0;              30;          32;S.C.                ;S.C.                ;           0;           0;          3;Terminales                                        ;Lg L20                                            
2015-11-18;         47;LG                                                ;Smarthphones y Masivos;               10;           1;                 0;               1;          11;S.C.                ;S.C.                ;           0;           0;          3;Terminales                                        ;Lg L3                                             
2015-11-18;         47;LG                                                ;Smarthphones y Masivos;                1;           0;                 0;               0;           1;S.C.                ;S.C.                ;           0;           0;          3;Terminales                                        ;Lg L3 II                                          
2015-11-18;         47;LG                                                ;Smarthphones y Masivos;              185;         137;                 1;             138;         323;69,0                ;161,5               ;           2;           6;          3;Terminales                                        ;Lg L40                                            
2015-11-18;         47;LG                                                ;Smarthphones y Masivos;                1;           8;                 0;               8;           9;S.C.                ;S.C.                ;           0;           0;          3;Terminales                                        ;Lg L5                                             
2015-11-18;         47;LG                                                ;Smarthphones y Masivos;              350;          41;                 1;              42;         392;S.C.                ;S.C.                ;           0;           0;          3;Terminales                                        ;Lg L5 II                                          
2015-11-18;         47;LG                                                ;Smarthphones y Masivos;                4;           2;                 0;               2;           6;S.C.                ;S.C.                ;           0;           0;          3;Terminales                                        ;Lg L50                                            
2015-11-18;         47;LG                                                ;Smarthphones y Masivos;               12;           7;                 4;              11;          23;S.C.                ;S.C.                ;           0;           0;          3;Terminales                                        ;Lg L7                                             
2015-11-18;         47;LG                                                ;Smarthphones y Masivos;              360;         154;                 0;             154;         514;231,0               ;771,0               ;           2;           2;          3;Terminales                                        ;Lg L70                                            
2015-11-18;         47;LG                                                ;Smarthphones y Masivos;                0;           6;                 1;               7;           7;S.C.                ;S.C.                ;           0;           0;          3;Terminales                                        ;Lg L9                                             
2015-11-18;         47;LG                                                ;Smarthphones y Masivos;             1254;        1116;               157;            1273;        2527;38,2                ;75,8                ;          23;         100;          3;Terminales                                        ;Lg Magna                                          
2015-11-18;         47;LG                                                ;Smarthphones y Masivos;                0;           2;                 0;               2;           2;S.C.                ;S.C.                ;           0;           0;          3;Terminales                                        ;Lg Optimus Live                                   
2015-11-18;         47;LG                                                ;Smarthphones y Masivos;                0;           1;                 0;               1;           1;S.C.                ;S.C.                ;           0;           0;          3;Terminales                                        ;Lg Optimus Pro                                    
2015-11-18;         47;LG                                                ;Smarthphones y Masivos;                1;           0;                 0;               0;           1;S.C.                ;S.C.                ;           0;           0;          3;Terminales                                        ;Lg P350                                           
2015-11-18;         47;LG                                                ;Smarthphones y Masivos;                0;           2;                 0;               2;           2;S.C.                ;S.C.                ;           0;           0;          3;Terminales                                        ;LG P500                                           
2015-11-18;         47;LG                                                ;Smarthphones y Masivos;                1;           0;                 0;               0;           1;S.C.                ;S.C.                ;           0;           0;          3;Terminales                                        ;Lg T3                                             
2015-11-18;         47;LG                                                ;Smarthphones y Masivos;                2;           0;                 0;               0;           2;S.C.                ;S.C.                ;           0;           0;          3;Terminales                                        ;Lg T300                                           
2015-11-19;         47;LG                                                ;iPhone y Premium      ;               53;          14;                 2;              16;          69;S.C.                ;S.C.                ;           0;           0;          4;Terminales                                        ;Lg G Flex (D956)                                  
2015-11-19;         47;LG                                                ;iPhone y Premium      ;               36;          94;                 3;              97;         133;388,0               ;532,0               ;           0;           1;          4;Terminales                                        ;Lg G2                                             
2015-11-19;         47;LG                                                ;iPhone y Premium      ;               47;         153;                 0;             153;         200;S.C.                ;S.C.                ;           0;           0;          4;Terminales                                        ;Lg G3 (D855)                                      
2015-11-19;         47;LG                                                ;iPhone y Premium      ;               68;         458;                93;             551;         619;47,9                ;53,8                ;          14;          46;          4;Terminales                                        ;Lg G4                                             
2015-11-19;         47;LG                                                ;Smarthphones y Masivos;               53;           0;                 0;               0;          53;S.C.                ;S.C.                ;           0;           0;          4;Terminales                                        ;Lg A1-A270                                        
2015-11-19;         47;LG                                                ;Smarthphones y Masivos;                1;           0;                 0;               0;           1;S.C.                ;S.C.                ;           0;           0;          4;Terminales                                        ;Lg C195                                           
2015-11-19;         47;LG                                                ;Smarthphones y Masivos;                2;          59;                 1;              60;          62;S.C.                ;S.C.                ;           0;           0;          4;Terminales                                        ;Lg C365                                           
2015-11-19;         47;LG                                                ;Smarthphones y Masivos;              202;         431;                 3;             434;         636;248,0               ;363,4               ;           2;           7;          4;Terminales                                        ;Lg G2 Mini                                        
2015-11-19;         47;LG                                                ;Smarthphones y Masivos;               46;         612;                26;             638;         684;127,6               ;136,8               ;           3;          20;          4;Terminales                                        ;Lg G3 Beat                                        
2015-11-19;         47;LG                                                ;Smarthphones y Masivos;                0;           1;                 0;               1;           1;S.C.                ;S.C.                ;           0;           0;          4;Terminales                                        ;Lg KP570                                          
2015-11-19;         47;LG                                                ;Smarthphones y Masivos;                4;           0;                 0;               0;           4;S.C.                ;S.C.                ;           0;           0;          4;Terminales                                        ;Lg L Lift                                         
2015-11-19;         47;LG                                                ;Smarthphones y Masivos;                2;          30;                 0;              30;          32;S.C.                ;S.C.                ;           0;           0;          4;Terminales                                        ;Lg L20                                            
2015-11-19;         47;LG                                                ;Smarthphones y Masivos;               10;           1;                 0;               1;          11;S.C.                ;S.C.                ;           0;           0;          4;Terminales                                        ;Lg L3                                             
2015-11-19;         47;LG                                                ;Smarthphones y Masivos;                1;           0;                 0;               0;           1;S.C.                ;S.C.                ;           0;           0;          4;Terminales                                        ;Lg L3 II                                          
2015-11-19;         47;LG                                                ;Smarthphones y Masivos;              185;         133;                 1;             134;         319;59,6                ;141,8               ;           3;           9;          4;Terminales                                        ;Lg L40                                            
2015-11-19;         47;LG                                                ;Smarthphones y Masivos;                1;           8;                 0;               8;           9;S.C.                ;S.C.                ;           0;           0;          4;Terminales                                        ;Lg L5                                             
2015-11-19;         47;LG                                                ;Smarthphones y Masivos;              350;          41;                 1;              42;         392;S.C.                ;S.C.                ;           0;           0;          4;Terminales                                        ;Lg L5 II                                          
2015-11-19;         47;LG                                                ;Smarthphones y Masivos;                4;           2;                 0;               2;           6;S.C.                ;S.C.                ;           0;           0;          4;Terminales                                        ;Lg L50                                            
2015-11-19;         47;LG                                                ;Smarthphones y Masivos;               12;           8;                 3;              11;          23;S.C.                ;S.C.                ;           0;           0;          4;Terminales                                        ;Lg L7                                             
2015-11-19;         47;LG                                                ;Smarthphones y Masivos;              360;         154;                 0;             154;         514;308,0               ;1028,0              ;           0;           2;          4;Terminales                                        ;Lg L70                                            
2015-11-19;         47;LG                                                ;Smarthphones y Masivos;                0;           6;                 1;               7;           7;S.C.                ;S.C.                ;           0;           0;          4;Terminales                                        ;Lg L9                                             
2015-11-19;         47;LG                                                ;Smarthphones y Masivos;             1254;        1098;               146;            1244;        2498;38,3                ;76,9                ;          30;         130;          4;Terminales                                        ;Lg Magna                                          
2015-11-19;         47;LG                                                ;Smarthphones y Masivos;                0;           2;                 0;               2;           2;S.C.                ;S.C.                ;           0;           0;          4;Terminales                                        ;Lg Optimus Live                                   
2015-11-19;         47;LG                                                ;Smarthphones y Masivos;                0;           1;                 0;               1;           1;S.C.                ;S.C.                ;           0;           0;          4;Terminales                                        ;Lg Optimus Pro                                    
2015-11-19;         47;LG                                                ;Smarthphones y Masivos;                1;           0;                 0;               0;           1;S.C.                ;S.C.                ;           0;           0;          4;Terminales                                        ;Lg P350                                           
2015-11-19;         47;LG                                                ;Smarthphones y Masivos;                0;           2;                 0;               2;           2;S.C.                ;S.C.                ;           0;           0;          4;Terminales                                        ;LG P500                                           
2015-11-19;         47;LG                                                ;Smarthphones y Masivos;                1;           0;                 0;               0;           1;S.C.                ;S.C.                ;           0;           0;          4;Terminales                                        ;Lg T3                                             
2015-11-19;         47;LG                                                ;Smarthphones y Masivos;                2;           0;                 0;               0;           2;S.C.                ;S.C.                ;           0;           0;          4;Terminales                                        ;Lg T300                                           
2015-11-20;         47;LG                                                ;iPhone y Premium      ;                0;           0;                 0;               0;           0;0,0                 ;0,0                 ;           0;           1;          5;Terminales                                        ;Lg G2                                             
2015-11-20;         47;LG                                                ;iPhone y Premium      ;                0;           0;                 0;               0;           0;0,0                 ;0,0                 ;          21;          67;          5;Terminales                                        ;Lg G4                                             
2015-11-20;         47;LG                                                ;Smarthphones y Masivos;                0;           0;                 0;               0;           0;0,0                 ;0,0                 ;           4;          11;          5;Terminales                                        ;Lg G2 Mini                                        
2015-11-20;         47;LG                                                ;Smarthphones y Masivos;                0;           0;                 0;               0;           0;0,0                 ;0,0                 ;           9;          29;          5;Terminales                                        ;Lg G3 Beat                                        
2015-11-20;         47;LG                                                ;Smarthphones y Masivos;                0;           0;                 0;               0;           0;0,0                 ;0,0                 ;           1;          10;          5;Terminales                                        ;Lg L40                                            
2015-11-20;         47;LG                                                ;Smarthphones y Masivos;                0;           0;                 0;               0;           0;0,0                 ;0,0                 ;           0;           2;          5;Terminales                                        ;Lg L70                                            
2015-11-20;         47;LG                                                ;Smarthphones y Masivos;                0;           0;                 0;               0;           0;0,0                 ;0,0                 ;          21;         151;          5;Terminales                                        ;Lg Magna                                          
2015-11-21;         47;LG                                                ;iPhone y Premium      ;                0;           0;                 0;               0;           0;0,0                 ;0,0                 ;           0;           1;          6;Terminales                                        ;Lg G2                                             
2015-11-21;         47;LG                                                ;iPhone y Premium      ;                0;           0;                 0;               0;           0;0,0                 ;0,0                 ;           0;          67;          6;Terminales                                        ;Lg G4                                             
2015-11-21;         47;LG                                                ;Smarthphones y Masivos;                0;           0;                 0;               0;           0;0,0                 ;0,0                 ;           0;          11;          6;Terminales                                        ;Lg G2 Mini                                        
2015-11-21;         47;LG                                                ;Smarthphones y Masivos;                0;           0;                 0;               0;           0;0,0                 ;0,0                 ;           1;          30;          6;Terminales                                        ;Lg G3 Beat                                        
2015-11-21;         47;LG                                                ;Smarthphones y Masivos;                0;           0;                 0;               0;           0;0,0                 ;0,0                 ;           0;          10;          6;Terminales                                        ;Lg L40                                            
2015-11-21;         47;LG                                                ;Smarthphones y Masivos;                0;           0;                 0;               0;           0;0,0                 ;0,0                 ;           0;           2;          6;Terminales                                        ;Lg L70                                            
2015-11-21;         47;LG                                                ;Smarthphones y Masivos;                0;           0;                 0;               0;           0;0,0                 ;0,0                 ;           6;         157;          6;Terminales                                        ;Lg Magna                                          
2015-11-22;         47;LG                                                ;iPhone y Premium      ;               53;          14;                 2;              16;          69;S.C.                ;S.C.                ;           0;           0;          7;Terminales                                        ;Lg G Flex (D956)                                  
2015-11-22;         47;LG                                                ;iPhone y Premium      ;               36;          94;                 3;              97;         133;679,0               ;931,0               ;           0;           1;          7;Terminales                                        ;Lg G2                                             
2015-11-22;         47;LG                                                ;iPhone y Premium      ;               47;         153;                 0;             153;         200;S.C.                ;S.C.                ;           0;           0;          7;Terminales                                        ;Lg G3 (D855)                                      
2015-11-22;         47;LG                                                ;iPhone y Premium      ;               68;         518;                12;             530;         598;55,4                ;62,5                ;           0;          67;          7;Terminales                                        ;Lg G4                                             
2015-11-22;         47;LG                                                ;Smarthphones y Masivos;               53;           0;                 0;               0;          53;S.C.                ;S.C.                ;           0;           0;          7;Terminales                                        ;Lg A1-A270                                        
2015-11-22;         47;LG                                                ;Smarthphones y Masivos;                1;           0;                 0;               0;           1;S.C.                ;S.C.                ;           0;           0;          7;Terminales                                        ;Lg C195                                           
2015-11-22;         47;LG                                                ;Smarthphones y Masivos;                2;          59;                 1;              60;          62;S.C.                ;S.C.                ;           0;           0;          7;Terminales                                        ;Lg C365                                           
2015-11-22;         47;LG                                                ;Smarthphones y Masivos;              205;         424;                 3;             427;         632;271,7               ;402,2               ;           0;          11;          7;Terminales                                        ;Lg G2 Mini                                        
2015-11-22;         47;LG                                                ;Smarthphones y Masivos;               47;         603;                23;             626;         673;141,4               ;152,0               ;           1;          31;          7;Terminales                                        ;Lg G3 Beat                                        
2015-11-22;         47;LG                                                ;Smarthphones y Masivos;                0;           1;                 0;               1;           1;S.C.                ;S.C.                ;           0;           0;          7;Terminales                                        ;Lg KP570                                          
2015-11-22;         47;LG                                                ;Smarthphones y Masivos;                4;           0;                 0;               0;           4;S.C.                ;S.C.                ;           0;           0;          7;Terminales                                        ;Lg L Lift                                         
2015-11-22;         47;LG                                                ;Smarthphones y Masivos;                2;          30;                 0;              30;          32;S.C.                ;S.C.                ;           0;           0;          7;Terminales                                        ;Lg L20                                            
2015-11-22;         47;LG                                                ;Smarthphones y Masivos;               10;           1;                 0;               1;          11;S.C.                ;S.C.                ;           0;           0;          7;Terminales                                        ;Lg L3                                             
2015-11-22;         47;LG                                                ;Smarthphones y Masivos;                1;           0;                 0;               0;           1;S.C.                ;S.C.                ;           0;           0;          7;Terminales                                        ;Lg L3 II                                          
2015-11-22;         47;LG                                                ;Smarthphones y Masivos;              186;         132;                 1;             133;         319;93,1                ;223,3               ;           0;          10;          7;Terminales                                        ;Lg L40                                            
2015-11-22;         47;LG                                                ;Smarthphones y Masivos;                1;           8;                 0;               8;           9;S.C.                ;S.C.                ;           0;           0;          7;Terminales                                        ;Lg L5                                             
2015-11-22;         47;LG                                                ;Smarthphones y Masivos;              350;          41;                 1;              42;         392;S.C.                ;S.C.                ;           0;           0;          7;Terminales                                        ;Lg L5 II                                          
2015-11-22;         47;LG                                                ;Smarthphones y Masivos;                4;           2;                 0;               2;           6;S.C.                ;S.C.                ;           0;           0;          7;Terminales                                        ;Lg L50                                            
2015-11-22;         47;LG                                                ;Smarthphones y Masivos;               12;           8;                 3;              11;          23;S.C.                ;S.C.                ;           0;           0;          7;Terminales                                        ;Lg L7                                             
2015-11-22;         47;LG                                                ;Smarthphones y Masivos;              176;         150;                 5;             155;         331;542,5               ;1158,5              ;           0;           2;          7;Terminales                                        ;Lg L70                                            
2015-11-22;         47;LG                                                ;Smarthphones y Masivos;                0;           6;                 1;               7;           7;S.C.                ;S.C.                ;           0;           0;          7;Terminales                                        ;Lg L9                                             
2015-11-22;         47;LG                                                ;Smarthphones y Masivos;             1331;        1164;                51;            1215;        2546;52,5                ;110,0               ;           5;         162;          7;Terminales                                        ;Lg Magna                                          
2015-11-22;         47;LG                                                ;Smarthphones y Masivos;                0;           2;                 0;               2;           2;S.C.                ;S.C.                ;           0;           0;          7;Terminales                                        ;Lg Optimus Live                                   
2015-11-22;         47;LG                                                ;Smarthphones y Masivos;                0;           1;                 0;               1;           1;S.C.                ;S.C.                ;           0;           0;          7;Terminales                                        ;Lg Optimus Pro                                    
2015-11-22;         47;LG                                                ;Smarthphones y Masivos;                1;           0;                 0;               0;           1;S.C.                ;S.C.                ;           0;           0;          7;Terminales                                        ;Lg P350                                           
2015-11-22;         47;LG                                                ;Smarthphones y Masivos;                0;           2;                 0;               2;           2;S.C.                ;S.C.                ;           0;           0;          7;Terminales                                        ;LG P500                                           
2015-11-22;         47;LG                                                ;Smarthphones y Masivos;                1;           0;                 0;               0;           1;S.C.                ;S.C.                ;           0;           0;          7;Terminales                                        ;Lg T3                                             
2015-11-22;         47;LG                                                ;Smarthphones y Masivos;                2;           0;                 0;               0;           2;S.C.                ;S.C.                ;           0;           0;          7;Terminales                                        ;Lg T300                                           
2015-11-23;         48;LG                                                ;iPhone y Premium      ;               54;          14;                 2;              16;          70;S.C.                ;S.C.                ;           0;           0;          1;Terminales                                        ;Lg G Flex (D956)                                  
2015-11-23;         48;LG                                                ;iPhone y Premium      ;               36;          94;                 3;              97;         133;S.C.                ;S.C.                ;           0;           0;          1;Terminales                                        ;Lg G2                                             
2015-11-23;         48;LG                                                ;iPhone y Premium      ;               50;         153;                 0;             153;         203;S.C.                ;S.C.                ;           0;           0;          1;Terminales                                        ;Lg G3 (D855)                                      
2015-11-23;         48;LG                                                ;iPhone y Premium      ;               68;         512;                 7;             519;         587;47,2                ;53,4                ;          11;          11;          1;Terminales                                        ;Lg G4                                             
2015-11-23;         48;LG                                                ;Smarthphones y Masivos;               53;           0;                 0;               0;          53;S.C.                ;S.C.                ;           0;           0;          1;Terminales                                        ;Lg A1-A270                                        
2015-11-23;         48;LG                                                ;Smarthphones y Masivos;                1;           0;                 0;               0;           1;S.C.                ;S.C.                ;           0;           0;          1;Terminales                                        ;Lg C195                                           
2015-11-23;         48;LG                                                ;Smarthphones y Masivos;                2;          59;                 1;              60;          62;S.C.                ;S.C.                ;           0;           0;          1;Terminales                                        ;Lg C365                                           
2015-11-23;         48;LG                                                ;Smarthphones y Masivos;              232;         417;                 3;             420;         652;60,0                ;93,1                ;           7;           7;          1;Terminales                                        ;Lg G2 Mini                                        
2015-11-23;         48;LG                                                ;Smarthphones y Masivos;               51;         602;                23;             625;         676;625,0               ;676,0               ;           1;           1;          1;Terminales                                        ;Lg G3 Beat                                        
2015-11-23;         48;LG                                                ;Smarthphones y Masivos;                0;           1;                 0;               1;           1;S.C.                ;S.C.                ;           0;           0;          1;Terminales                                        ;Lg KP570                                          
2015-11-23;         48;LG                                                ;Smarthphones y Masivos;                4;           0;                 0;               0;           4;S.C.                ;S.C.                ;           0;           0;          1;Terminales                                        ;Lg L Lift                                         
2015-11-23;         48;LG                                                ;Smarthphones y Masivos;                2;          30;                 0;              30;          32;S.C.                ;S.C.                ;           0;           0;          1;Terminales                                        ;Lg L20                                            
2015-11-23;         48;LG                                                ;Smarthphones y Masivos;               10;           1;                 0;               1;          11;S.C.                ;S.C.                ;           0;           0;          1;Terminales                                        ;Lg L3                                             
2015-11-23;         48;LG                                                ;Smarthphones y Masivos;                1;           0;                 0;               0;           1;S.C.                ;S.C.                ;           0;           0;          1;Terminales                                        ;Lg L3 II                                          
2015-11-23;         48;LG                                                ;Smarthphones y Masivos;              194;         129;                 1;             130;         324;43,3                ;108,0               ;           3;           3;          1;Terminales                                        ;Lg L40                                            
2015-11-23;         48;LG                                                ;Smarthphones y Masivos;                2;           8;                 0;               8;          10;S.C.                ;S.C.                ;           0;           0;          1;Terminales                                        ;Lg L5                                             
2015-11-23;         48;LG                                                ;Smarthphones y Masivos;              355;          41;                 1;              42;         397;S.C.                ;S.C.                ;           0;           0;          1;Terminales                                        ;Lg L5 II                                          
2015-11-23;         48;LG                                                ;Smarthphones y Masivos;                4;           2;                 0;               2;           6;S.C.                ;S.C.                ;           0;           0;          1;Terminales                                        ;Lg L50                                            
2015-11-23;         48;LG                                                ;Smarthphones y Masivos;               15;           8;                 3;              11;          26;S.C.                ;S.C.                ;           0;           0;          1;Terminales                                        ;Lg L7                                             
2015-11-23;         48;LG                                                ;Smarthphones y Masivos;              179;         149;                 5;             154;         333;S.C.                ;S.C.                ;           0;           0;          1;Terminales                                        ;Lg L70                                            
2015-11-23;         48;LG                                                ;Smarthphones y Masivos;                0;           6;                 1;               7;           7;S.C.                ;S.C.                ;           0;           0;          1;Terminales                                        ;Lg L9                                             
2015-11-23;         48;LG                                                ;Smarthphones y Masivos;              413;        1186;               946;            2132;        2545;236,9               ;282,8               ;           9;           9;          1;Terminales                                        ;Lg Magna                                          
2015-11-23;         48;LG                                                ;Smarthphones y Masivos;                0;           2;                 0;               2;           2;S.C.                ;S.C.                ;           0;           0;          1;Terminales                                        ;Lg Optimus Live                                   
2015-11-23;         48;LG                                                ;Smarthphones y Masivos;                0;           1;                 0;               1;           1;S.C.                ;S.C.                ;           0;           0;          1;Terminales                                        ;Lg Optimus Pro                                    
2015-11-23;         48;LG                                                ;Smarthphones y Masivos;                1;           0;                 0;               0;           1;S.C.                ;S.C.                ;           0;           0;          1;Terminales                                        ;Lg P350                                           
2015-11-23;         48;LG                                                ;Smarthphones y Masivos;                0;           2;                 0;               2;           2;S.C.                ;S.C.                ;           0;           0;          1;Terminales                                        ;LG P500                                           
2015-11-23;         48;LG                                                ;Smarthphones y Masivos;                1;           0;                 0;               0;           1;S.C.                ;S.C.                ;           0;           0;          1;Terminales                                        ;Lg T3                                             
2015-11-23;         48;LG                                                ;Smarthphones y Masivos;                2;           0;                 0;               0;           2;S.C.                ;S.C.                ;           0;           0;          1;Terminales                                        ;Lg T300                                           
2015-11-24;         48;LG                                                ;iPhone y Premium      ;               54;          14;                 2;              16;          70;S.C.                ;S.C.                ;           0;           0;          2;Terminales                                        ;Lg G Flex (D956)                                  
2015-11-24;         48;LG                                                ;iPhone y Premium      ;               36;          98;                 3;             101;         137;S.C.                ;S.C.                ;           0;           0;          2;Terminales                                        ;Lg G2                                             
2015-11-24;         48;LG                                                ;iPhone y Premium      ;               50;         153;                 0;             153;         203;S.C.                ;S.C.                ;           0;           0;          2;Terminales                                        ;Lg G3 (D855)                                      
2015-11-24;         48;LG                                                ;iPhone y Premium      ;               61;         508;                 8;             516;         577;49,1                ;55,0                ;          10;          21;          2;Terminales                                        ;Lg G4                                             
2015-11-24;         48;LG                                                ;Smarthphones y Masivos;               53;           0;                 0;               0;          53;S.C.                ;S.C.                ;           0;           0;          2;Terminales                                        ;Lg A1-A270                                        
2015-11-24;         48;LG                                                ;Smarthphones y Masivos;                1;           0;                 0;               0;           1;S.C.                ;S.C.                ;           0;           0;          2;Terminales                                        ;Lg C195                                           
2015-11-24;         48;LG                                                ;Smarthphones y Masivos;                2;          59;                 1;              60;          62;S.C.                ;S.C.                ;           0;           0;          2;Terminales                                        ;Lg C365                                           
2015-11-24;         48;LG                                                ;Smarthphones y Masivos;              232;         421;                 3;             424;         656;106,0               ;164,0               ;           1;           8;          2;Terminales                                        ;Lg G2 Mini                                        
2015-11-24;         48;LG                                                ;Smarthphones y Masivos;               51;         617;                 4;             621;         672;248,4               ;268,8               ;           4;           5;          2;Terminales                                        ;Lg G3 Beat                                        
2015-11-24;         48;LG                                                ;Smarthphones y Masivos;                0;           1;                 0;               1;           1;S.C.                ;S.C.                ;           0;           0;          2;Terminales                                        ;Lg KP570                                          
2015-11-24;         48;LG                                                ;Smarthphones y Masivos;                4;           0;                 0;               0;           4;S.C.                ;S.C.                ;           0;           0;          2;Terminales                                        ;Lg L Lift                                         
2015-11-24;         48;LG                                                ;Smarthphones y Masivos;                2;          30;                 0;              30;          32;S.C.                ;S.C.                ;           0;           0;          2;Terminales                                        ;Lg L20                                            
2015-11-24;         48;LG                                                ;Smarthphones y Masivos;               10;           1;                 0;               1;          11;S.C.                ;S.C.                ;           0;           0;          2;Terminales                                        ;Lg L3                                             
2015-11-24;         48;LG                                                ;Smarthphones y Masivos;                1;           0;                 0;               0;           1;S.C.                ;S.C.                ;           0;           0;          2;Terminales                                        ;Lg L3 II                                          
2015-11-24;         48;LG                                                ;Smarthphones y Masivos;              194;         137;                 1;             138;         332;92,0                ;221,3               ;           0;           3;          2;Terminales                                        ;Lg L40                                            
2015-11-24;         48;LG                                                ;Smarthphones y Masivos;                2;           8;                 0;               8;          10;S.C.                ;S.C.                ;           0;           0;          2;Terminales                                        ;Lg L5                                             
2015-11-24;         48;LG                                                ;Smarthphones y Masivos;              355;          46;                 1;              47;         402;S.C.                ;S.C.                ;           0;           0;          2;Terminales                                        ;Lg L5 II                                          
2015-11-24;         48;LG                                                ;Smarthphones y Masivos;                4;           2;                 0;               2;           6;S.C.                ;S.C.                ;           0;           0;          2;Terminales                                        ;Lg L50                                            
2015-11-24;         48;LG                                                ;Smarthphones y Masivos;               15;           8;                 3;              11;          26;S.C.                ;S.C.                ;           0;           0;          2;Terminales                                        ;Lg L7                                             
2015-11-24;         48;LG                                                ;Smarthphones y Masivos;              179;         154;                 0;             154;         333;S.C.                ;S.C.                ;           0;           0;          2;Terminales                                        ;Lg L70                                            
2015-11-24;         48;LG                                                ;Smarthphones y Masivos;                0;           6;                 1;               7;           7;S.C.                ;S.C.                ;           0;           0;          2;Terminales                                        ;Lg L9                                             
2015-11-24;         48;LG                                                ;Smarthphones y Masivos;              275;        1436;               815;            2251;        2526;166,7               ;187,1               ;          18;          27;          2;Terminales                                        ;Lg Magna                                          
2015-11-24;         48;LG                                                ;Smarthphones y Masivos;                0;           2;                 0;               2;           2;S.C.                ;S.C.                ;           0;           0;          2;Terminales                                        ;Lg Optimus Live                                   
2015-11-24;         48;LG                                                ;Smarthphones y Masivos;                0;           1;                 0;               1;           1;S.C.                ;S.C.                ;           0;           0;          2;Terminales                                        ;Lg Optimus Pro                                    
2015-11-24;         48;LG                                                ;Smarthphones y Masivos;                1;           0;                 0;               0;           1;S.C.                ;S.C.                ;           0;           0;          2;Terminales                                        ;Lg P350                                           
2015-11-24;         48;LG                                                ;Smarthphones y Masivos;                0;           2;                 0;               2;           2;S.C.                ;S.C.                ;           0;           0;          2;Terminales                                        ;LG P500                                           
2015-11-24;         48;LG                                                ;Smarthphones y Masivos;                1;           0;                 0;               0;           1;S.C.                ;S.C.                ;           0;           0;          2;Terminales                                        ;Lg T3                                             
2015-11-24;         48;LG                                                ;Smarthphones y Masivos;                2;           0;                 0;               0;           2;S.C.                ;S.C.                ;           0;           0;          2;Terminales                                        ;Lg T300                                           
2015-11-25;         48;LG                                                ;iPhone y Premium      ;               54;          15;                 1;              16;          70;S.C.                ;S.C.                ;           0;           0;          3;Terminales                                        ;Lg G Flex (D956)                                  
2015-11-25;         48;LG                                                ;iPhone y Premium      ;               36;         100;                 1;             101;         137;S.C.                ;S.C.                ;           0;           0;          3;Terminales                                        ;Lg G2                                             
2015-11-25;         48;LG                                                ;iPhone y Premium      ;               50;         152;                 0;             152;         202;456,0               ;606,0               ;           1;           1;          3;Terminales                                        ;Lg G3 (D855)                                      
2015-11-25;         48;LG                                                ;iPhone y Premium      ;               61;         505;                 8;             513;         574;66,9                ;74,9                ;           2;          23;          3;Terminales                                        ;Lg G4                                             
2015-11-25;         48;LG                                                ;Smarthphones y Masivos;               53;           0;                 0;               0;          53;S.C.                ;S.C.                ;           0;           0;          3;Terminales                                        ;Lg A1-A270                                        
2015-11-25;         48;LG                                                ;Smarthphones y Masivos;                1;           0;                 0;               0;           1;S.C.                ;S.C.                ;           0;           0;          3;Terminales                                        ;Lg C195                                           
2015-11-25;         48;LG                                                ;Smarthphones y Masivos;                2;          59;                 1;              60;          62;S.C.                ;S.C.                ;           0;           0;          3;Terminales                                        ;Lg C365                                           
2015-11-25;         48;LG                                                ;Smarthphones y Masivos;              232;         418;                 1;             419;         651;139,7               ;217,0               ;           1;           9;          3;Terminales                                        ;Lg G2 Mini                                        
2015-11-25;         48;LG                                                ;Smarthphones y Masivos;               51;         616;                 4;             620;         671;265,7               ;287,6               ;           2;           7;          3;Terminales                                        ;Lg G3 Beat                                        
2015-11-25;         48;LG                                                ;Smarthphones y Masivos;                0;           1;                 0;               1;           1;S.C.                ;S.C.                ;           0;           0;          3;Terminales                                        ;Lg KP570                                          
2015-11-25;         48;LG                                                ;Smarthphones y Masivos;                4;           0;                 0;               0;           4;S.C.                ;S.C.                ;           0;           0;          3;Terminales                                        ;Lg L Lift                                         
2015-11-25;         48;LG                                                ;Smarthphones y Masivos;                2;          30;                 0;              30;          32;S.C.                ;S.C.                ;           0;           0;          3;Terminales                                        ;Lg L20                                            
2015-11-25;         48;LG                                                ;Smarthphones y Masivos;               10;           1;                 0;               1;          11;S.C.                ;S.C.                ;           0;           0;          3;Terminales                                        ;Lg L3                                             
2015-11-25;         48;LG                                                ;Smarthphones y Masivos;                1;           0;                 0;               0;           1;S.C.                ;S.C.                ;           0;           0;          3;Terminales                                        ;Lg L3 II                                          
2015-11-25;         48;LG                                                ;Smarthphones y Masivos;              193;         136;                 1;             137;         330;137,0               ;330,0               ;           0;           3;          3;Terminales                                        ;Lg L40                                            
2015-11-25;         48;LG                                                ;Smarthphones y Masivos;                2;           8;                 0;               8;          10;S.C.                ;S.C.                ;           0;           0;          3;Terminales                                        ;Lg L5                                             
2015-11-25;         48;LG                                                ;Smarthphones y Masivos;              167;          46;                 1;              47;         214;S.C.                ;S.C.                ;           0;           0;          3;Terminales                                        ;Lg L5 II                                          
2015-11-25;         48;LG                                                ;Smarthphones y Masivos;                4;           2;                 0;               2;           6;S.C.                ;S.C.                ;           0;           0;          3;Terminales                                        ;Lg L50                                            
2015-11-25;         48;LG                                                ;Smarthphones y Masivos;               15;           9;                 2;              11;          26;S.C.                ;S.C.                ;           0;           0;          3;Terminales                                        ;Lg L7                                             
2015-11-25;         48;LG                                                ;Smarthphones y Masivos;               95;         153;                 3;             156;         251;468,0               ;753,0               ;           1;           1;          3;Terminales                                        ;Lg L70                                            
2015-11-25;         48;LG                                                ;Smarthphones y Masivos;                0;           7;                 0;               7;           7;S.C.                ;S.C.                ;           0;           0;          3;Terminales                                        ;Lg L9                                             
2015-11-25;         48;LG                                                ;Smarthphones y Masivos;              275;        1947;               280;            2227;        2502;133,6               ;150,1               ;          23;          50;          3;Terminales                                        ;Lg Magna                                          
2015-11-25;         48;LG                                                ;Smarthphones y Masivos;                0;           2;                 0;               2;           2;S.C.                ;S.C.                ;           0;           0;          3;Terminales                                        ;Lg Optimus Live                                   
2015-11-25;         48;LG                                                ;Smarthphones y Masivos;                0;           1;                 0;               1;           1;S.C.                ;S.C.                ;           0;           0;          3;Terminales                                        ;Lg Optimus Pro                                    
2015-11-25;         48;LG                                                ;Smarthphones y Masivos;                1;           0;                 0;               0;           1;S.C.                ;S.C.                ;           0;           0;          3;Terminales                                        ;Lg P350                                           
2015-11-25;         48;LG                                                ;Smarthphones y Masivos;                0;           2;                 0;               2;           2;S.C.                ;S.C.                ;           0;           0;          3;Terminales                                        ;LG P500                                           
2015-11-25;         48;LG                                                ;Smarthphones y Masivos;                1;           0;                 0;               0;           1;S.C.                ;S.C.                ;           0;           0;          3;Terminales                                        ;Lg T3                                             
2015-11-25;         48;LG                                                ;Smarthphones y Masivos;                2;           0;                 0;               0;           2;S.C.                ;S.C.                ;           0;           0;          3;Terminales                                        ;Lg T300                                           
2015-11-26;         48;LG                                                ;iPhone y Premium      ;               54;          16;                 0;              16;          70;S.C.                ;S.C.                ;           0;           0;          4;Terminales                                        ;Lg G Flex (D956)                                  
2015-11-26;         48;LG                                                ;iPhone y Premium      ;               36;         101;                 0;             101;         137;S.C.                ;S.C.                ;           0;           0;          4;Terminales                                        ;Lg G2                                             
2015-11-26;         48;LG                                                ;iPhone y Premium      ;               50;         152;                 0;             152;         202;608,0               ;808,0               ;           0;           1;          4;Terminales                                        ;Lg G3 (D855)                                      
2015-11-26;         48;LG                                                ;iPhone y Premium      ;               61;         500;                 8;             508;         569;75,3                ;84,3                ;           4;          27;          4;Terminales                                        ;Lg G4                                             
2015-11-26;         48;LG                                                ;Smarthphones y Masivos;               53;           0;                 0;               0;          53;S.C.                ;S.C.                ;           0;           0;          4;Terminales                                        ;Lg A1-A270                                        
2015-11-26;         48;LG                                                ;Smarthphones y Masivos;                1;           0;                 0;               0;           1;S.C.                ;S.C.                ;           0;           0;          4;Terminales                                        ;Lg C195                                           
2015-11-26;         48;LG                                                ;Smarthphones y Masivos;                2;          59;                 1;              60;          62;S.C.                ;S.C.                ;           0;           0;          4;Terminales                                        ;Lg C365                                           
2015-11-26;         48;LG                                                ;Smarthphones y Masivos;              232;         412;                 0;             412;         644;96,9                ;151,5               ;           8;          17;          4;Terminales                                        ;Lg G2 Mini                                        
2015-11-26;         48;LG                                                ;Smarthphones y Masivos;               44;         614;                11;             625;         669;277,8               ;297,3               ;           2;           9;          4;Terminales                                        ;Lg G3 Beat                                        
2015-11-26;         48;LG                                                ;Smarthphones y Masivos;                0;           1;                 0;               1;           1;S.C.                ;S.C.                ;           0;           0;          4;Terminales                                        ;Lg KP570                                          
2015-11-26;         48;LG                                                ;Smarthphones y Masivos;                4;           0;                 0;               0;           4;S.C.                ;S.C.                ;           0;           0;          4;Terminales                                        ;Lg L Lift                                         
2015-11-26;         48;LG                                                ;Smarthphones y Masivos;                2;          30;                 0;              30;          32;S.C.                ;S.C.                ;           0;           0;          4;Terminales                                        ;Lg L20                                            
2015-11-26;         48;LG                                                ;Smarthphones y Masivos;               10;           1;                 0;               1;          11;S.C.                ;S.C.                ;           0;           0;          4;Terminales                                        ;Lg L3                                             
2015-11-26;         48;LG                                                ;Smarthphones y Masivos;                1;           0;                 0;               0;           1;S.C.                ;S.C.                ;           0;           0;          4;Terminales                                        ;Lg L3 II                                          
2015-11-26;         48;LG                                                ;Smarthphones y Masivos;              193;         136;                 0;             136;         329;136,0               ;329,0               ;           1;           4;          4;Terminales                                        ;Lg L40                                            
2015-11-26;         48;LG                                                ;Smarthphones y Masivos;                2;           8;                 0;               8;          10;S.C.                ;S.C.                ;           0;           0;          4;Terminales                                        ;Lg L5                                             
2015-11-26;         48;LG                                                ;Smarthphones y Masivos;              165;          47;                 0;              47;         212;S.C.                ;S.C.                ;           0;           0;          4;Terminales                                        ;Lg L5 II                                          
2015-11-26;         48;LG                                                ;Smarthphones y Masivos;                4;           2;                 0;               2;           6;S.C.                ;S.C.                ;           0;           0;          4;Terminales                                        ;Lg L50                                            
2015-11-26;         48;LG                                                ;Smarthphones y Masivos;               15;          10;                 1;              11;          26;S.C.                ;S.C.                ;           0;           0;          4;Terminales                                        ;Lg L7                                             
2015-11-26;         48;LG                                                ;Smarthphones y Masivos;               90;         152;                 3;             155;         245;310,0               ;490,0               ;           1;           2;          4;Terminales                                        ;Lg L70                                            
2015-11-26;         48;LG                                                ;Smarthphones y Masivos;                0;           7;                 0;               7;           7;S.C.                ;S.C.                ;           0;           0;          4;Terminales                                        ;Lg L9                                             
2015-11-26;         48;LG                                                ;Smarthphones y Masivos;              278;        2087;               114;            2201;        2479;127,6               ;143,7               ;          19;          69;          4;Terminales                                        ;Lg Magna                                          
2015-11-26;         48;LG                                                ;Smarthphones y Masivos;                0;           2;                 0;               2;           2;S.C.                ;S.C.                ;           0;           0;          4;Terminales                                        ;Lg Optimus Live                                   
2015-11-26;         48;LG                                                ;Smarthphones y Masivos;                0;           1;                 0;               1;           1;S.C.                ;S.C.                ;           0;           0;          4;Terminales                                        ;Lg Optimus Pro                                    
2015-11-26;         48;LG                                                ;Smarthphones y Masivos;                1;           0;                 0;               0;           1;S.C.                ;S.C.                ;           0;           0;          4;Terminales                                        ;Lg P350                                           
2015-11-26;         48;LG                                                ;Smarthphones y Masivos;                0;           2;                 0;               2;           2;S.C.                ;S.C.                ;           0;           0;          4;Terminales                                        ;LG P500                                           
2015-11-26;         48;LG                                                ;Smarthphones y Masivos;                1;           0;                 0;               0;           1;S.C.                ;S.C.                ;           0;           0;          4;Terminales                                        ;Lg T3                                             
2015-11-26;         48;LG                                                ;Smarthphones y Masivos;                2;           0;                 0;               0;           2;S.C.                ;S.C.                ;           0;           0;          4;Terminales                                        ;Lg T300                                           
2015-11-27;         48;LG                                                ;iPhone y Premium      ;                0;           0;                 0;               0;           0;0,0                 ;0,0                 ;           1;           2;          5;Terminales                                        ;Lg G3 (D855)                                      
2015-11-27;         48;LG                                                ;iPhone y Premium      ;                0;           0;                 0;               0;           0;0,0                 ;0,0                 ;           6;          33;          5;Terminales                                        ;Lg G4                                             
2015-11-27;         48;LG                                                ;Smarthphones y Masivos;                0;           0;                 0;               0;           0;0,0                 ;0,0                 ;           2;          19;          5;Terminales                                        ;Lg G2 Mini                                        
2015-11-27;         48;LG                                                ;Smarthphones y Masivos;                0;           0;                 0;               0;           0;0,0                 ;0,0                 ;           7;          16;          5;Terminales                                        ;Lg G3 Beat                                        
2015-11-27;         48;LG                                                ;Smarthphones y Masivos;                0;           0;                 0;               0;           0;0,0                 ;0,0                 ;           0;           4;          5;Terminales                                        ;Lg L40                                            
2015-11-27;         48;LG                                                ;Smarthphones y Masivos;                0;           0;                 0;               0;           0;0,0                 ;0,0                 ;           5;           7;          5;Terminales                                        ;Lg L70                                            
2015-11-27;         48;LG                                                ;Smarthphones y Masivos;                0;           0;                 0;               0;           0;0,0                 ;0,0                 ;          25;          94;          5;Terminales                                        ;Lg Magna                                          
2015-11-28;         48;LG                                                ;iPhone y Premium      ;                0;           0;                 0;               0;           0;0,0                 ;0,0                 ;           0;           2;          6;Terminales                                        ;Lg G3 (D855)                                      
2015-11-28;         48;LG                                                ;iPhone y Premium      ;                0;           0;                 0;               0;           0;0,0                 ;0,0                 ;           1;          34;          6;Terminales                                        ;Lg G4                                             
2015-11-28;         48;LG                                                ;Smarthphones y Masivos;                0;           0;                 0;               0;           0;0,0                 ;0,0                 ;           0;          19;          6;Terminales                                        ;Lg G2 Mini                                        
2015-11-28;         48;LG                                                ;Smarthphones y Masivos;                0;           0;                 0;               0;           0;0,0                 ;0,0                 ;           1;          17;          6;Terminales                                        ;Lg G3 Beat                                        
2015-11-28;         48;LG                                                ;Smarthphones y Masivos;                0;           0;                 0;               0;           0;0,0                 ;0,0                 ;           0;           4;          6;Terminales                                        ;Lg L40                                            
2015-11-28;         48;LG                                                ;Smarthphones y Masivos;                0;           0;                 0;               0;           0;0,0                 ;0,0                 ;           0;           7;          6;Terminales                                        ;Lg L70                                            
2015-11-28;         48;LG                                                ;Smarthphones y Masivos;                0;           0;                 0;               0;           0;0,0                 ;0,0                 ;          12;         106;          6;Terminales                                        ;Lg Magna                                          
2015-11-29;         48;LG                                                ;iPhone y Premium      ;               54;          16;                 0;              16;          70;S.C.                ;S.C.                ;           0;           0;          7;Terminales                                        ;Lg G Flex (D956)                                  
2015-11-29;         48;LG                                                ;iPhone y Premium      ;               39;         101;                 0;             101;         140;S.C.                ;S.C.                ;           0;           0;          7;Terminales                                        ;Lg G2                                             
2015-11-29;         48;LG                                                ;iPhone y Premium      ;               52;         150;                 1;             151;         203;528,5               ;710,5               ;           0;           2;          7;Terminales                                        ;Lg G3 (D855)                                      
2015-11-29;         48;LG                                                ;iPhone y Premium      ;               63;         487;                 8;             495;         558;101,9               ;114,9               ;           0;          34;          7;Terminales                                        ;Lg G4                                             
2015-11-29;         48;LG                                                ;Smarthphones y Masivos;               53;           0;                 0;               0;          53;S.C.                ;S.C.                ;           0;           0;          7;Terminales                                        ;Lg A1-A270                                        
2015-11-29;         48;LG                                                ;Smarthphones y Masivos;                1;           0;                 0;               0;           1;S.C.                ;S.C.                ;           0;           0;          7;Terminales                                        ;Lg C195                                           
2015-11-29;         48;LG                                                ;Smarthphones y Masivos;                2;          59;                 1;              60;          62;S.C.                ;S.C.                ;           0;           0;          7;Terminales                                        ;Lg C365                                           
2015-11-29;         48;LG                                                ;Smarthphones y Masivos;              238;         409;                 0;             409;         647;150,7               ;238,4               ;           0;          19;          7;Terminales                                        ;Lg G2 Mini                                        
2015-11-29;         48;LG                                                ;Smarthphones y Masivos;               51;         604;                11;             615;         666;253,2               ;274,2               ;           0;          17;          7;Terminales                                        ;Lg G3 Beat                                        
2015-11-29;         48;LG                                                ;Smarthphones y Masivos;                0;           1;                 0;               1;           1;S.C.                ;S.C.                ;           0;           0;          7;Terminales                                        ;Lg KP570                                          
2015-11-29;         48;LG                                                ;Smarthphones y Masivos;                4;           0;                 0;               0;           4;S.C.                ;S.C.                ;           0;           0;          7;Terminales                                        ;Lg L Lift                                         
2015-11-29;         48;LG                                                ;Smarthphones y Masivos;                2;          30;                 0;              30;          32;S.C.                ;S.C.                ;           0;           0;          7;Terminales                                        ;Lg L20                                            
2015-11-29;         48;LG                                                ;Smarthphones y Masivos;               10;           1;                 0;               1;          11;S.C.                ;S.C.                ;           0;           0;          7;Terminales                                        ;Lg L3                                             
2015-11-29;         48;LG                                                ;Smarthphones y Masivos;                1;           0;                 0;               0;           1;S.C.                ;S.C.                ;           0;           0;          7;Terminales                                        ;Lg L3 II                                          
2015-11-29;         48;LG                                                ;Smarthphones y Masivos;              197;         136;                 0;             136;         333;238,0               ;582,8               ;           0;           4;          7;Terminales                                        ;Lg L40                                            
2015-11-29;         48;LG                                                ;Smarthphones y Masivos;                2;           8;                 0;               8;          10;S.C.                ;S.C.                ;           0;           0;          7;Terminales                                        ;Lg L5                                             
2015-11-29;         48;LG                                                ;Smarthphones y Masivos;              165;          46;                 0;              46;         211;S.C.                ;S.C.                ;           0;           0;          7;Terminales                                        ;Lg L5 II                                          
2015-11-29;         48;LG                                                ;Smarthphones y Masivos;                4;           2;                 0;               2;           6;S.C.                ;S.C.                ;           0;           0;          7;Terminales                                        ;Lg L50                                            
2015-11-29;         48;LG                                                ;Smarthphones y Masivos;               15;          10;                 1;              11;          26;S.C.                ;S.C.                ;           0;           0;          7;Terminales                                        ;Lg L7                                             
2015-11-29;         48;LG                                                ;Smarthphones y Masivos;               90;         147;                 3;             150;         240;150,0               ;240,0               ;           0;           7;          7;Terminales                                        ;Lg L70                                            
2015-11-29;         48;LG                                                ;Smarthphones y Masivos;                0;           7;                 0;               7;           7;S.C.                ;S.C.                ;           0;           0;          7;Terminales                                        ;Lg L9                                             
2015-11-29;         48;LG                                                ;Smarthphones y Masivos;             2269;        2099;                68;            2167;        4436;135,4               ;277,3               ;           6;         112;          7;Terminales                                        ;Lg Magna                                          
2015-11-29;         48;LG                                                ;Smarthphones y Masivos;                0;           2;                 0;               2;           2;S.C.                ;S.C.                ;           0;           0;          7;Terminales                                        ;Lg Optimus Live                                   
2015-11-29;         48;LG                                                ;Smarthphones y Masivos;                0;           1;                 0;               1;           1;S.C.                ;S.C.                ;           0;           0;          7;Terminales                                        ;Lg Optimus Pro                                    
2015-11-29;         48;LG                                                ;Smarthphones y Masivos;                1;           0;                 0;               0;           1;S.C.                ;S.C.                ;           0;           0;          7;Terminales                                        ;Lg P350                                           
2015-11-29;         48;LG                                                ;Smarthphones y Masivos;                0;           2;                 0;               2;           2;S.C.                ;S.C.                ;           0;           0;          7;Terminales                                        ;LG P500                                           
2015-11-29;         48;LG                                                ;Smarthphones y Masivos;                1;           0;                 0;               0;           1;S.C.                ;S.C.                ;           0;           0;          7;Terminales                                        ;Lg T3                                             
2015-11-29;         48;LG                                                ;Smarthphones y Masivos;                2;           0;                 0;               0;           2;S.C.                ;S.C.                ;           0;           0;          7;Terminales                                        ;Lg T300                                           
2015-11-30;         49;LG                                                ;iPhone y Premium      ;               54;          16;                 0;              16;          70;S.C.                ;S.C.                ;           0;           0;          1;Terminales                                        ;Lg G Flex (D956)                                  
2015-11-30;         49;LG                                                ;iPhone y Premium      ;               39;         101;                 0;             101;         140;S.C.                ;S.C.                ;           0;           0;          1;Terminales                                        ;Lg G2                                             
2015-11-30;         49;LG                                                ;iPhone y Premium      ;               52;         150;                 1;             151;         203;S.C.                ;S.C.                ;           0;           0;          1;Terminales                                        ;Lg G3 (D855)                                      
2015-11-30;         49;LG                                                ;iPhone y Premium      ;               63;         475;                 8;             483;         546;48,3                ;54,6                ;          10;          10;          1;Terminales                                        ;Lg G4                                             
2015-11-30;         49;LG                                                ;Smarthphones y Masivos;               53;           0;                 0;               0;          53;S.C.                ;S.C.                ;           0;           0;          1;Terminales                                        ;Lg A1-A270                                        
2015-11-30;         49;LG                                                ;Smarthphones y Masivos;                1;           0;                 0;               0;           1;S.C.                ;S.C.                ;           0;           0;          1;Terminales                                        ;Lg C195                                           
2015-11-30;         49;LG                                                ;Smarthphones y Masivos;                2;          59;                 1;              60;          62;S.C.                ;S.C.                ;           0;           0;          1;Terminales                                        ;Lg C365                                           
2015-11-30;         49;LG                                                ;Smarthphones y Masivos;              250;         386;                 0;             386;         636;64,3                ;106,0               ;           6;           6;          1;Terminales                                        ;Lg G2 Mini                                        
2015-11-30;         49;LG                                                ;Smarthphones y Masivos;               51;         605;                 4;             609;         660;121,8               ;132,0               ;           5;           5;          1;Terminales                                        ;Lg G3 Beat                                        
2015-11-30;         49;LG                                                ;Smarthphones y Masivos;                0;           1;                 0;               1;           1;S.C.                ;S.C.                ;           0;           0;          1;Terminales                                        ;Lg KP570                                          
2015-11-30;         49;LG                                                ;Smarthphones y Masivos;                4;           0;                 0;               0;           4;S.C.                ;S.C.                ;           0;           0;          1;Terminales                                        ;Lg L Lift                                         
2015-11-30;         49;LG                                                ;Smarthphones y Masivos;                2;          30;                 0;              30;          32;S.C.                ;S.C.                ;           0;           0;          1;Terminales                                        ;Lg L20                                            
2015-11-30;         49;LG                                                ;Smarthphones y Masivos;               10;           1;                 0;               1;          11;S.C.                ;S.C.                ;           0;           0;          1;Terminales                                        ;Lg L3                                             
2015-11-30;         49;LG                                                ;Smarthphones y Masivos;                1;           0;                 0;               0;           1;S.C.                ;S.C.                ;           0;           0;          1;Terminales                                        ;Lg L3 II                                          
2015-11-30;         49;LG                                                ;Smarthphones y Masivos;              198;         135;                 0;             135;         333;S.C.                ;S.C.                ;           0;           0;          1;Terminales                                        ;Lg L40                                            
2015-11-30;         49;LG                                                ;Smarthphones y Masivos;                2;           8;                 0;               8;          10;S.C.                ;S.C.                ;           0;           0;          1;Terminales                                        ;Lg L5                                             
2015-11-30;         49;LG                                                ;Smarthphones y Masivos;              165;          45;                 0;              45;         210;S.C.                ;S.C.                ;           0;           0;          1;Terminales                                        ;Lg L5 II                                          
2015-11-30;         49;LG                                                ;Smarthphones y Masivos;                4;           2;                 0;               2;           6;S.C.                ;S.C.                ;           0;           0;          1;Terminales                                        ;Lg L50                                            
2015-11-30;         49;LG                                                ;Smarthphones y Masivos;               15;          10;                 1;              11;          26;S.C.                ;S.C.                ;           0;           0;          1;Terminales                                        ;Lg L7                                             
2015-11-30;         49;LG                                                ;Smarthphones y Masivos;               90;         142;                 3;             145;         235;72,5                ;117,5               ;           2;           2;          1;Terminales                                        ;Lg L70                                            
2015-11-30;         49;LG                                                ;Smarthphones y Masivos;                0;           7;                 0;               7;           7;S.C.                ;S.C.                ;           0;           0;          1;Terminales                                        ;Lg L9                                             
2015-11-30;         49;LG                                                ;Smarthphones y Masivos;             2091;        2143;                33;            2176;        4267;51,8                ;101,6               ;          42;          42;          1;Terminales                                        ;Lg Magna                                          
2015-11-30;         49;LG                                                ;Smarthphones y Masivos;                0;           2;                 0;               2;           2;S.C.                ;S.C.                ;           0;           0;          1;Terminales                                        ;Lg Optimus Live                                   
2015-11-30;         49;LG                                                ;Smarthphones y Masivos;                0;           1;                 0;               1;           1;S.C.                ;S.C.                ;           0;           0;          1;Terminales                                        ;Lg Optimus Pro                                    
2015-11-30;         49;LG                                                ;Smarthphones y Masivos;                1;           0;                 0;               0;           1;S.C.                ;S.C.                ;           0;           0;          1;Terminales                                        ;Lg P350                                           
2015-11-30;         49;LG                                                ;Smarthphones y Masivos;                0;           2;                 0;               2;           2;S.C.                ;S.C.                ;           0;           0;          1;Terminales                                        ;LG P500                                           
2015-11-30;         49;LG                                                ;Smarthphones y Masivos;                1;           0;                 0;               0;           1;S.C.                ;S.C.                ;           0;           0;          1;Terminales                                        ;Lg T3                                             
2015-11-30;         49;LG                                                ;Smarthphones y Masivos;                2;           0;                 0;               0;           2;S.C.                ;S.C.                ;           0;           0;          1;Terminales                                        ;Lg T300                                           
2015-11-16;         47;Motorola                                          ;iPhone y Premium      ;                0;           2;                 0;               2;           2;S.C.                ;S.C.                ;           0;           0;          1;Terminales                                        ;MOT Razr                                          
2015-11-16;         47;Motorola                                          ;Smarthphones y Masivos;               18;           3;                 0;               3;          21;S.C.                ;S.C.                ;           0;           0;          1;Terminales                                        ;MOT 303                                           
2015-11-16;         47;Motorola                                          ;Smarthphones y Masivos;                0;           2;                 0;               2;           2;S.C.                ;S.C.                ;           0;           0;          1;Terminales                                        ;MOT Defy Mini                                     
2015-11-16;         47;Motorola                                          ;Smarthphones y Masivos;                2;           1;                 0;               1;           3;S.C.                ;S.C.                ;           0;           0;          1;Terminales                                        ;MOT Domino +                                      
2015-11-16;         47;Motorola                                          ;Smarthphones y Masivos;                0;           2;                 0;               2;           2;S.C.                ;S.C.                ;           0;           0;          1;Terminales                                        ;MOT EX225                                         
2015-11-16;         47;Motorola                                          ;Smarthphones y Masivos;            10138;        3115;               209;            3324;       13462;48,2                ;195,1               ;          69;          69;          1;Terminales                                        ;MOT Moto G 2DA                                    
2015-11-16;         47;Motorola                                          ;Smarthphones y Masivos;             8703;        2244;               114;            2358;       11061;37,4                ;175,6               ;          63;          63;          1;Terminales                                        ;MOT Moto G 3RA                                    
2015-11-16;         47;Motorola                                          ;Smarthphones y Masivos;              106;        1012;                 2;            1014;        1120;-1014,0             ;-1120,0             ;          -1;          -1;          1;Terminales                                        ;MOT Moto G Lte                                    
2015-11-16;         47;Motorola                                          ;Smarthphones y Masivos;             4192;        1752;                75;            1827;        6019;49,4                ;162,7               ;          37;          37;          1;Terminales                                        ;MOT Moto X Play                                   
2015-11-16;         47;Motorola                                          ;Smarthphones y Masivos;                0;           3;                 0;               3;           3;S.C.                ;S.C.                ;           0;           0;          1;Terminales                                        ;MOT XT914                                         
2015-11-17;         47;Motorola                                          ;iPhone y Premium      ;                0;           2;                 0;               2;           2;S.C.                ;S.C.                ;           0;           0;          2;Terminales                                        ;MOT Razr                                          
2015-11-17;         47;Motorola                                          ;Smarthphones y Masivos;               18;           3;                 0;               3;          21;S.C.                ;S.C.                ;           0;           0;          2;Terminales                                        ;MOT 303                                           
2015-11-17;         47;Motorola                                          ;Smarthphones y Masivos;                0;           2;                 0;               2;           2;S.C.                ;S.C.                ;           0;           0;          2;Terminales                                        ;MOT Defy Mini                                     
2015-11-17;         47;Motorola                                          ;Smarthphones y Masivos;                2;           1;                 0;               1;           3;S.C.                ;S.C.                ;           0;           0;          2;Terminales                                        ;MOT Domino +                                      
2015-11-17;         47;Motorola                                          ;Smarthphones y Masivos;                0;           2;                 0;               2;           2;S.C.                ;S.C.                ;           0;           0;          2;Terminales                                        ;MOT EX225                                         
2015-11-17;         47;Motorola                                          ;Smarthphones y Masivos;            10086;        3144;               150;            3294;       13380;46,4                ;188,5               ;          73;         142;          2;Terminales                                        ;MOT Moto G 2DA                                    
2015-11-17;         47;Motorola                                          ;Smarthphones y Masivos;             8595;        2269;               123;            2392;       10987;33,7                ;154,7               ;          79;         142;          2;Terminales                                        ;MOT Moto G 3RA                                    
2015-11-17;         47;Motorola                                          ;Smarthphones y Masivos;              106;        1009;                 2;            1011;        1117;S.C.                ;S.C.                ;           1;           0;          2;Terminales                                        ;MOT Moto G Lte                                    
2015-11-17;         47;Motorola                                          ;Smarthphones y Masivos;             4148;        1759;                83;            1842;        5990;56,7                ;184,3               ;          28;          65;          2;Terminales                                        ;MOT Moto X Play                                   
2015-11-17;         47;Motorola                                          ;Smarthphones y Masivos;                0;           3;                 0;               3;           3;S.C.                ;S.C.                ;           0;           0;          2;Terminales                                        ;MOT XT914                                         
2015-11-18;         47;Motorola                                          ;iPhone y Premium      ;                0;           2;                 0;               2;           2;S.C.                ;S.C.                ;           0;           0;          3;Terminales                                        ;MOT Razr                                          
2015-11-18;         47;Motorola                                          ;Smarthphones y Masivos;               18;           3;                 0;               3;          21;S.C.                ;S.C.                ;           0;           0;          3;Terminales                                        ;MOT 303                                           
2015-11-18;         47;Motorola                                          ;Smarthphones y Masivos;                0;           2;                 0;               2;           2;S.C.                ;S.C.                ;           0;           0;          3;Terminales                                        ;MOT Defy Mini                                     
2015-11-18;         47;Motorola                                          ;Smarthphones y Masivos;                2;           1;                 0;               1;           3;S.C.                ;S.C.                ;           0;           0;          3;Terminales                                        ;MOT Domino +                                      
2015-11-18;         47;Motorola                                          ;Smarthphones y Masivos;                0;           2;                 0;               2;           2;S.C.                ;S.C.                ;           0;           0;          3;Terminales                                        ;MOT EX225                                         
2015-11-18;         47;Motorola                                          ;Smarthphones y Masivos;            10048;        3094;               178;            3272;       13320;49,8                ;202,8               ;          55;         197;          3;Terminales                                        ;MOT Moto G 2DA                                    
2015-11-18;         47;Motorola                                          ;Smarthphones y Masivos;             8541;        2204;               138;            2342;       10883;29,8                ;138,3               ;          94;         236;          3;Terminales                                        ;MOT Moto G 3RA                                    
2015-11-18;         47;Motorola                                          ;Smarthphones y Masivos;              113;        1011;                 2;            1013;        1126;S.C.                ;S.C.                ;           0;           0;          3;Terminales                                        ;MOT Moto G Lte                                    
2015-11-18;         47;Motorola                                          ;Smarthphones y Masivos;             4106;        1747;               100;            1847;        5953;54,9                ;176,8               ;          36;         101;          3;Terminales                                        ;MOT Moto X Play                                   
2015-11-18;         47;Motorola                                          ;Smarthphones y Masivos;                1;           3;                 0;               3;           4;S.C.                ;S.C.                ;           0;           0;          3;Terminales                                        ;MOT XT914                                         
2015-11-18;         47;Motorola                                          ;Smarthphones y Masivos;                1;           0;                 0;               0;           1;S.C.                ;S.C.                ;           0;           0;          3;Terminales                                        ;MOT XT919                                         
2015-11-19;         47;Motorola                                          ;iPhone y Premium      ;                0;           2;                 0;               2;           2;S.C.                ;S.C.                ;           0;           0;          4;Terminales                                        ;MOT Razr                                          
2015-11-19;         47;Motorola                                          ;Smarthphones y Masivos;               18;           3;                 0;               3;          21;S.C.                ;S.C.                ;           0;           0;          4;Terminales                                        ;MOT 303                                           
2015-11-19;         47;Motorola                                          ;Smarthphones y Masivos;                0;           2;                 0;               2;           2;S.C.                ;S.C.                ;           0;           0;          4;Terminales                                        ;MOT Defy Mini                                     
2015-11-19;         47;Motorola                                          ;Smarthphones y Masivos;                2;           1;                 0;               1;           3;S.C.                ;S.C.                ;           0;           0;          4;Terminales                                        ;MOT Domino +                                      
2015-11-19;         47;Motorola                                          ;Smarthphones y Masivos;                0;           2;                 0;               2;           2;S.C.                ;S.C.                ;           0;           0;          4;Terminales                                        ;MOT EX225                                         
2015-11-19;         47;Motorola                                          ;Smarthphones y Masivos;             9988;        3052;               209;            3261;       13249;50,4                ;204,6               ;          62;         259;          4;Terminales                                        ;MOT Moto G 2DA                                    
2015-11-19;         47;Motorola                                          ;Smarthphones y Masivos;             8724;        2156;               142;            2298;       11022;31,2                ;149,5               ;          59;         295;          4;Terminales                                        ;MOT Moto G 3RA                                    
2015-11-19;         47;Motorola                                          ;Smarthphones y Masivos;              113;        1007;                 2;            1009;        1122;2018,0              ;2244,0              ;           2;           2;          4;Terminales                                        ;MOT Moto G Lte                                    
2015-11-19;         47;Motorola                                          ;Smarthphones y Masivos;             4224;        1745;                84;            1829;        6053;60,0                ;198,5               ;          21;         122;          4;Terminales                                        ;MOT Moto X Play                                   
2015-11-19;         47;Motorola                                          ;Smarthphones y Masivos;                1;           3;                 0;               3;           4;S.C.                ;S.C.                ;           0;           0;          4;Terminales                                        ;MOT XT914                                         
2015-11-19;         47;Motorola                                          ;Smarthphones y Masivos;                1;           0;                 0;               0;           1;S.C.                ;S.C.                ;           0;           0;          4;Terminales                                        ;MOT XT919                                         
2015-11-20;         47;Motorola                                          ;Smarthphones y Masivos;                0;           0;                 0;               0;           0;0,0                 ;0,0                 ;          80;         339;          5;Terminales                                        ;MOT Moto G 2DA                                    
2015-11-20;         47;Motorola                                          ;Smarthphones y Masivos;                0;           0;                 0;               0;           0;0,0                 ;0,0                 ;          72;         367;          5;Terminales                                        ;MOT Moto G 3RA                                    
2015-11-20;         47;Motorola                                          ;Smarthphones y Masivos;                0;           0;                 0;               0;           0;0,0                 ;0,0                 ;           3;           5;          5;Terminales                                        ;MOT Moto G Lte                                    
2015-11-20;         47;Motorola                                          ;Smarthphones y Masivos;                0;           0;                 0;               0;           0;0,0                 ;0,0                 ;          52;         174;          5;Terminales                                        ;MOT Moto X Play                                   
2015-11-21;         47;Motorola                                          ;Smarthphones y Masivos;                0;           0;                 0;               0;           0;0,0                 ;0,0                 ;          32;         371;          6;Terminales                                        ;MOT Moto G 2DA                                    
2015-11-21;         47;Motorola                                          ;Smarthphones y Masivos;                0;           0;                 0;               0;           0;0,0                 ;0,0                 ;          20;         387;          6;Terminales                                        ;MOT Moto G 3RA                                    
2015-11-21;         47;Motorola                                          ;Smarthphones y Masivos;                0;           0;                 0;               0;           0;0,0                 ;0,0                 ;           0;           5;          6;Terminales                                        ;MOT Moto G Lte                                    
2015-11-21;         47;Motorola                                          ;Smarthphones y Masivos;                0;           0;                 0;               0;           0;0,0                 ;0,0                 ;           7;         181;          6;Terminales                                        ;MOT Moto X Play                                   
2015-11-22;         47;Motorola                                          ;iPhone y Premium      ;                0;           2;                 0;               2;           2;S.C.                ;S.C.                ;           0;           0;          7;Terminales                                        ;MOT Razr                                          
2015-11-22;         47;Motorola                                          ;Smarthphones y Masivos;               18;           3;                 0;               3;          21;S.C.                ;S.C.                ;           0;           0;          7;Terminales                                        ;MOT 303                                           
2015-11-22;         47;Motorola                                          ;Smarthphones y Masivos;                0;           2;                 0;               2;           2;S.C.                ;S.C.                ;           0;           0;          7;Terminales                                        ;MOT Defy Mini                                     
2015-11-22;         47;Motorola                                          ;Smarthphones y Masivos;                2;           1;                 0;               1;           3;S.C.                ;S.C.                ;           0;           0;          7;Terminales                                        ;MOT Domino +                                      
2015-11-22;         47;Motorola                                          ;Smarthphones y Masivos;                0;           2;                 0;               2;           2;S.C.                ;S.C.                ;           0;           0;          7;Terminales                                        ;MOT EX225                                         
2015-11-22;         47;Motorola                                          ;Smarthphones y Masivos;             9903;        2998;               226;            3224;       13127;60,2                ;245,0               ;           4;         375;          7;Terminales                                        ;MOT Moto G 2DA                                    
2015-11-22;         47;Motorola                                          ;Smarthphones y Masivos;             8655;        2146;               115;            2261;       10916;39,8                ;192,0               ;          11;         398;          7;Terminales                                        ;MOT Moto G 3RA                                    
2015-11-22;         47;Motorola                                          ;Smarthphones y Masivos;              113;        1002;                 2;            1004;        1117;1405,6              ;1563,8              ;           0;           5;          7;Terminales                                        ;MOT Moto G Lte                                    
2015-11-22;         47;Motorola                                          ;Smarthphones y Masivos;             4156;        1731;               105;            1836;        5992;70,6                ;230,5               ;           1;         182;          7;Terminales                                        ;MOT Moto X Play                                   
2015-11-22;         47;Motorola                                          ;Smarthphones y Masivos;                1;           3;                 0;               3;           4;S.C.                ;S.C.                ;           0;           0;          7;Terminales                                        ;MOT XT914                                         
2015-11-22;         47;Motorola                                          ;Smarthphones y Masivos;                1;           0;                 0;               0;           1;S.C.                ;S.C.                ;           0;           0;          7;Terminales                                        ;MOT XT919                                         
2015-11-23;         48;Motorola                                          ;iPhone y Premium      ;                0;           2;                 0;               2;           2;S.C.                ;S.C.                ;           0;           0;          1;Terminales                                        ;MOT Razr                                          
2015-11-23;         48;Motorola                                          ;Smarthphones y Masivos;               19;           3;                 0;               3;          22;S.C.                ;S.C.                ;           0;           0;          1;Terminales                                        ;MOT 303                                           
2015-11-23;         48;Motorola                                          ;Smarthphones y Masivos;                0;           2;                 0;               2;           2;S.C.                ;S.C.                ;           0;           0;          1;Terminales                                        ;MOT Defy Mini                                     
2015-11-23;         48;Motorola                                          ;Smarthphones y Masivos;                2;           1;                 0;               1;           3;S.C.                ;S.C.                ;           0;           0;          1;Terminales                                        ;MOT Domino +                                      
2015-11-23;         48;Motorola                                          ;Smarthphones y Masivos;                0;           2;                 0;               2;           2;S.C.                ;S.C.                ;           0;           0;          1;Terminales                                        ;MOT EX225                                         
2015-11-23;         48;Motorola                                          ;Smarthphones y Masivos;             9842;        2990;               218;            3208;       13050;39,6                ;161,1               ;          81;          81;          1;Terminales                                        ;MOT Moto G 2DA                                    
2015-11-23;         48;Motorola                                          ;Smarthphones y Masivos;             8408;        2097;               341;            2438;       10846;34,3                ;152,8               ;          71;          71;          1;Terminales                                        ;MOT Moto G 3RA                                    
2015-11-23;         48;Motorola                                          ;Smarthphones y Masivos;              123;        1001;                 1;            1002;        1125;1002,0              ;1125,0              ;           1;           1;          1;Terminales                                        ;MOT Moto G Lte                                    
2015-11-23;         48;Motorola                                          ;Smarthphones y Masivos;             4057;        1736;               166;            1902;        5959;59,4                ;186,2               ;          32;          32;          1;Terminales                                        ;MOT Moto X Play                                   
2015-11-23;         48;Motorola                                          ;Smarthphones y Masivos;                4;           3;                 0;               3;           7;S.C.                ;S.C.                ;           0;           0;          1;Terminales                                        ;MOT XT914                                         
2015-11-23;         48;Motorola                                          ;Smarthphones y Masivos;                1;           0;                 0;               0;           1;S.C.                ;S.C.                ;           0;           0;          1;Terminales                                        ;MOT XT919                                         
2015-11-24;         48;Motorola                                          ;iPhone y Premium      ;                0;           2;                 0;               2;           2;S.C.                ;S.C.                ;           0;           0;          2;Terminales                                        ;MOT Razr                                          
2015-11-24;         48;Motorola                                          ;Smarthphones y Masivos;               19;           3;                 0;               3;          22;S.C.                ;S.C.                ;           0;           0;          2;Terminales                                        ;MOT 303                                           
2015-11-24;         48;Motorola                                          ;Smarthphones y Masivos;                0;           2;                 0;               2;           2;S.C.                ;S.C.                ;           0;           0;          2;Terminales                                        ;MOT Defy Mini                                     
2015-11-24;         48;Motorola                                          ;Smarthphones y Masivos;                2;           1;                 0;               1;           3;S.C.                ;S.C.                ;           0;           0;          2;Terminales                                        ;MOT Domino +                                      
2015-11-24;         48;Motorola                                          ;Smarthphones y Masivos;                0;           2;                 0;               2;           2;S.C.                ;S.C.                ;           0;           0;          2;Terminales                                        ;MOT EX225                                         
2015-11-24;         48;Motorola                                          ;Smarthphones y Masivos;             9713;        3031;               240;            3271;       12984;47,4                ;188,2               ;          57;         138;          2;Terminales                                        ;MOT Moto G 2DA                                    
2015-11-24;         48;Motorola                                          ;Smarthphones y Masivos;             8286;        2208;               276;            2484;       10770;34,7                ;150,6               ;          72;         143;          2;Terminales                                        ;MOT Moto G 3RA                                    
2015-11-24;         48;Motorola                                          ;Smarthphones y Masivos;              123;         975;                 1;             976;        1099;650,7               ;732,7               ;           2;           3;          2;Terminales                                        ;MOT Moto G Lte                                    
2015-11-24;         48;Motorola                                          ;Smarthphones y Masivos;             4036;        1785;               114;            1899;        5935;66,6                ;208,2               ;          25;          57;          2;Terminales                                        ;MOT Moto X Play                                   
2015-11-24;         48;Motorola                                          ;Smarthphones y Masivos;                4;           3;                 0;               3;           7;S.C.                ;S.C.                ;           0;           0;          2;Terminales                                        ;MOT XT914                                         
2015-11-24;         48;Motorola                                          ;Smarthphones y Masivos;                1;           0;                 0;               0;           1;S.C.                ;S.C.                ;           0;           0;          2;Terminales                                        ;MOT XT919                                         
2015-11-25;         48;Motorola                                          ;iPhone y Premium      ;                0;           2;                 0;               2;           2;S.C.                ;S.C.                ;           0;           0;          3;Terminales                                        ;MOT Razr                                          
2015-11-25;         48;Motorola                                          ;Smarthphones y Masivos;               19;           3;                 0;               3;          22;S.C.                ;S.C.                ;           0;           0;          3;Terminales                                        ;MOT 303                                           
2015-11-25;         48;Motorola                                          ;Smarthphones y Masivos;                0;           2;                 0;               2;           2;S.C.                ;S.C.                ;           0;           0;          3;Terminales                                        ;MOT Defy Mini                                     
2015-11-25;         48;Motorola                                          ;Smarthphones y Masivos;                2;           1;                 0;               1;           3;S.C.                ;S.C.                ;           0;           0;          3;Terminales                                        ;MOT Domino +                                      
2015-11-25;         48;Motorola                                          ;Smarthphones y Masivos;                0;           2;                 0;               2;           2;S.C.                ;S.C.                ;           0;           0;          3;Terminales                                        ;MOT EX225                                         
2015-11-25;         48;Motorola                                          ;Smarthphones y Masivos;             9654;        2957;               264;            3221;       12875;39,6                ;158,3               ;         106;         244;          3;Terminales                                        ;MOT Moto G 2DA                                    
2015-11-25;         48;Motorola                                          ;Smarthphones y Masivos;             8235;        2265;               215;            2480;       10715;38,8                ;167,4               ;          49;         192;          3;Terminales                                        ;MOT Moto G 3RA                                    
2015-11-25;         48;Motorola                                          ;Smarthphones y Masivos;              123;         974;                 1;             975;        1098;731,3               ;823,5               ;           1;           4;          3;Terminales                                        ;MOT Moto G Lte                                    
2015-11-25;         48;Motorola                                          ;Smarthphones y Masivos;             3998;        1798;                72;            1870;        5868;46,8                ;146,7               ;          63;         120;          3;Terminales                                        ;MOT Moto X Play                                   
2015-11-25;         48;Motorola                                          ;Smarthphones y Masivos;                4;           3;                 0;               3;           7;S.C.                ;S.C.                ;           0;           0;          3;Terminales                                        ;MOT XT914                                         
2015-11-25;         48;Motorola                                          ;Smarthphones y Masivos;                1;           0;                 0;               0;           1;S.C.                ;S.C.                ;           0;           0;          3;Terminales                                        ;MOT XT919                                         
2015-11-26;         48;Motorola                                          ;iPhone y Premium      ;                0;           2;                 0;               2;           2;S.C.                ;S.C.                ;           0;           0;          4;Terminales                                        ;MOT Razr                                          
2015-11-26;         48;Motorola                                          ;Smarthphones y Masivos;               19;           3;                 0;               3;          22;S.C.                ;S.C.                ;           0;           0;          4;Terminales                                        ;MOT 303                                           
2015-11-26;         48;Motorola                                          ;Smarthphones y Masivos;                0;           2;                 0;               2;           2;S.C.                ;S.C.                ;           0;           0;          4;Terminales                                        ;MOT Defy Mini                                     
2015-11-26;         48;Motorola                                          ;Smarthphones y Masivos;                2;           1;                 0;               1;           3;S.C.                ;S.C.                ;           0;           0;          4;Terminales                                        ;MOT Domino +                                      
2015-11-26;         48;Motorola                                          ;Smarthphones y Masivos;                0;           2;                 0;               2;           2;S.C.                ;S.C.                ;           0;           0;          4;Terminales                                        ;MOT EX225                                         
2015-11-26;         48;Motorola                                          ;Smarthphones y Masivos;             9633;        2981;               190;            3171;       12804;40,4                ;163,1               ;          70;         314;          4;Terminales                                        ;MOT Moto G 2DA                                    
2015-11-26;         48;Motorola                                          ;Smarthphones y Masivos;             8205;        2264;               202;            2466;       10671;42,2                ;182,4               ;          42;         234;          4;Terminales                                        ;MOT Moto G 3RA                                    
2015-11-26;         48;Motorola                                          ;Smarthphones y Masivos;              123;         974;                 0;             974;        1097;779,2               ;877,6               ;           1;           5;          4;Terminales                                        ;MOT Moto G Lte                                    
2015-11-26;         48;Motorola                                          ;Smarthphones y Masivos;             3990;        1792;                56;            1848;        5838;51,3                ;162,2               ;          24;         144;          4;Terminales                                        ;MOT Moto X Play                                   
2015-11-26;         48;Motorola                                          ;Smarthphones y Masivos;                4;           3;                 0;               3;           7;S.C.                ;S.C.                ;           0;           0;          4;Terminales                                        ;MOT XT914                                         
2015-11-26;         48;Motorola                                          ;Smarthphones y Masivos;                1;           0;                 0;               0;           1;S.C.                ;S.C.                ;           0;           0;          4;Terminales                                        ;MOT XT919                                         
2015-11-27;         48;Motorola                                          ;Smarthphones y Masivos;                0;           0;                 0;               0;           0;0,0                 ;0,0                 ;          94;         408;          5;Terminales                                        ;MOT Moto G 2DA                                    
2015-11-27;         48;Motorola                                          ;Smarthphones y Masivos;                0;           0;                 0;               0;           0;0,0                 ;0,0                 ;          53;         287;          5;Terminales                                        ;MOT Moto G 3RA                                    
2015-11-27;         48;Motorola                                          ;Smarthphones y Masivos;                0;           0;                 0;               0;           0;0,0                 ;0,0                 ;           2;           7;          5;Terminales                                        ;MOT Moto G Lte                                    
2015-11-27;         48;Motorola                                          ;Smarthphones y Masivos;                0;           0;                 0;               0;           0;0,0                 ;0,0                 ;          32;         176;          5;Terminales                                        ;MOT Moto X Play                                   
2015-11-28;         48;Motorola                                          ;Smarthphones y Masivos;                0;           0;                 0;               0;           0;0,0                 ;0,0                 ;          50;         458;          6;Terminales                                        ;MOT Moto G 2DA                                    
2015-11-28;         48;Motorola                                          ;Smarthphones y Masivos;                0;           0;                 0;               0;           0;0,0                 ;0,0                 ;          15;         302;          6;Terminales                                        ;MOT Moto G 3RA                                    
2015-11-28;         48;Motorola                                          ;Smarthphones y Masivos;                0;           0;                 0;               0;           0;0,0                 ;0,0                 ;           0;           7;          6;Terminales                                        ;MOT Moto G Lte                                    
2015-11-28;         48;Motorola                                          ;Smarthphones y Masivos;                0;           0;                 0;               0;           0;0,0                 ;0,0                 ;           8;         184;          6;Terminales                                        ;MOT Moto X Play                                   
2015-11-29;         48;Motorola                                          ;iPhone y Premium      ;                0;           2;                 0;               2;           2;S.C.                ;S.C.                ;           0;           0;          7;Terminales                                        ;MOT Razr                                          
2015-11-29;         48;Motorola                                          ;Smarthphones y Masivos;               19;           3;                 0;               3;          22;S.C.                ;S.C.                ;           0;           0;          7;Terminales                                        ;MOT 303                                           
2015-11-29;         48;Motorola                                          ;Smarthphones y Masivos;                0;           2;                 0;               2;           2;S.C.                ;S.C.                ;           0;           0;          7;Terminales                                        ;MOT Defy Mini                                     
2015-11-29;         48;Motorola                                          ;Smarthphones y Masivos;                2;           1;                 0;               1;           3;S.C.                ;S.C.                ;           0;           0;          7;Terminales                                        ;MOT Domino +                                      
2015-11-29;         48;Motorola                                          ;Smarthphones y Masivos;                0;           2;                 0;               2;           2;S.C.                ;S.C.                ;           0;           0;          7;Terminales                                        ;MOT EX225                                         
2015-11-29;         48;Motorola                                          ;Smarthphones y Masivos;             9578;        2860;               214;            3074;       12652;45,9                ;188,8               ;          11;         469;          7;Terminales                                        ;MOT Moto G 2DA                                    
2015-11-29;         48;Motorola                                          ;Smarthphones y Masivos;             8143;        2231;               228;            2459;       10602;56,6                ;244,1               ;           2;         304;          7;Terminales                                        ;MOT Moto G 3RA                                    
2015-11-29;         48;Motorola                                          ;Smarthphones y Masivos;              124;         970;                 0;             970;        1094;848,8               ;957,3               ;           1;           8;          7;Terminales                                        ;MOT Moto G Lte                                    
2015-11-29;         48;Motorola                                          ;Smarthphones y Masivos;             3949;        1776;                69;            1845;        5794;69,8                ;219,2               ;           1;         185;          7;Terminales                                        ;MOT Moto X Play                                   
2015-11-29;         48;Motorola                                          ;Smarthphones y Masivos;                4;           3;                 0;               3;           7;S.C.                ;S.C.                ;           0;           0;          7;Terminales                                        ;MOT XT914                                         
2015-11-29;         48;Motorola                                          ;Smarthphones y Masivos;                1;           0;                 0;               0;           1;S.C.                ;S.C.                ;           0;           0;          7;Terminales                                        ;MOT XT919                                         
2015-11-30;         49;Motorola                                          ;iPhone y Premium      ;                0;           2;                 0;               2;           2;S.C.                ;S.C.                ;           0;           0;          1;Terminales                                        ;MOT Razr                                          
2015-11-30;         49;Motorola                                          ;Smarthphones y Masivos;               19;           3;                 0;               3;          22;S.C.                ;S.C.                ;           0;           0;          1;Terminales                                        ;MOT 303                                           
2015-11-30;         49;Motorola                                          ;Smarthphones y Masivos;                0;           2;                 0;               2;           2;S.C.                ;S.C.                ;           0;           0;          1;Terminales                                        ;MOT Defy Mini                                     
2015-11-30;         49;Motorola                                          ;Smarthphones y Masivos;                2;           1;                 0;               1;           3;S.C.                ;S.C.                ;           0;           0;          1;Terminales                                        ;MOT Domino +                                      
2015-11-30;         49;Motorola                                          ;Smarthphones y Masivos;                0;           2;                 0;               2;           2;S.C.                ;S.C.                ;           0;           0;          1;Terminales                                        ;MOT EX225                                         
2015-11-30;         49;Motorola                                          ;Smarthphones y Masivos;             9502;        2843;               201;            3044;       12546;29,6                ;121,8               ;         103;         103;          1;Terminales                                        ;MOT Moto G 2DA                                    
2015-11-30;         49;Motorola                                          ;Smarthphones y Masivos;             8010;        2307;               237;            2544;       10554;55,3                ;229,4               ;          46;          46;          1;Terminales                                        ;MOT Moto G 3RA                                    
2015-11-30;         49;Motorola                                          ;Smarthphones y Masivos;              124;         970;                 0;             970;        1094;S.C.                ;S.C.                ;           0;           0;          1;Terminales                                        ;MOT Moto G Lte                                    
2015-11-30;         49;Motorola                                          ;Smarthphones y Masivos;             3893;        1749;               111;            1860;        5753;48,9                ;151,4               ;          38;          38;          1;Terminales                                        ;MOT Moto X Play                                   
2015-11-30;         49;Motorola                                          ;Smarthphones y Masivos;                4;           3;                 0;               3;           7;S.C.                ;S.C.                ;           0;           0;          1;Terminales                                        ;MOT XT914                                         
2015-11-30;         49;Motorola                                          ;Smarthphones y Masivos;                1;           0;                 0;               0;           1;S.C.                ;S.C.                ;           0;           0;          1;Terminales                                        ;MOT XT919                                         
2015-11-16;         47;Nokia                                             ;iPhone y Premium      ;                2;           0;                 0;               0;           2;S.C.                ;S.C.                ;           0;           0;          1;Terminales                                        ;NOK 900                                           
2015-11-16;         47;Nokia                                             ;iPhone y Premium      ;                0;           1;                 1;               2;           2;S.C.                ;S.C.                ;           0;           0;          1;Terminales                                        ;NOK 925                                           
2015-11-16;         47;Nokia                                             ;iPhone y Premium      ;                1;           1;                 0;               1;           2;S.C.                ;S.C.                ;           0;           0;          1;Terminales                                        ;NOK N800                                          
2015-11-16;         47;Nokia                                             ;Smarthphones y Masivos;              774;         224;                 0;             224;         998;S.C.                ;S.C.                ;           0;           0;          1;Terminales                                        ;NOK 106                                           
2015-11-16;         47;Nokia                                             ;Smarthphones y Masivos;               39;          36;                 0;              36;          75;S.C.                ;S.C.                ;           0;           0;          1;Terminales                                        ;NOK 111                                           
2015-11-16;         47;Nokia                                             ;Smarthphones y Masivos;               35;          13;                 0;              13;          48;S.C.                ;S.C.                ;           0;           0;          1;Terminales                                        ;NOK 1320                                          
2015-11-16;         47;Nokia                                             ;Smarthphones y Masivos;                3;           2;                 0;               2;           5;S.C.                ;S.C.                ;           0;           0;          1;Terminales                                        ;NOK 210                                           
2015-11-16;         47;Nokia                                             ;Smarthphones y Masivos;            11293;        9726;               380;           10106;       21399;41,6                ;88,1                ;         243;         243;          1;Terminales                                        ;NOK 220                                           
2015-11-16;         47;Nokia                                             ;Smarthphones y Masivos;              131;           1;                 0;               1;         132;S.C.                ;S.C.                ;           0;           0;          1;Terminales                                        ;NOK 230                                           
2015-11-16;         47;Nokia                                             ;Smarthphones y Masivos;                1;           3;                 0;               3;           4;S.C.                ;S.C.                ;           0;           0;          1;Terminales                                        ;NOK 302                                           
2015-11-16;         47;Nokia                                             ;Smarthphones y Masivos;                0;           2;                 1;               3;           3;S.C.                ;S.C.                ;           0;           0;          1;Terminales                                        ;NOK 510                                           
2015-11-16;         47;Nokia                                             ;Smarthphones y Masivos;              116;         444;                 3;             447;         563;S.C.                ;S.C.                ;           0;           0;          1;Terminales                                        ;NOK 520                                           
2015-11-16;         47;Nokia                                             ;Smarthphones y Masivos;                1;           0;                 0;               0;           1;S.C.                ;S.C.                ;           0;           0;          1;Terminales                                        ;NOK 5230                                          
2015-11-16;         47;Nokia                                             ;Smarthphones y Masivos;                0;           1;                 0;               1;           1;S.C.                ;S.C.                ;           0;           0;          1;Terminales                                        ;NOK 610                                           
2015-11-16;         47;Nokia                                             ;Smarthphones y Masivos;              235;          72;                 1;              73;         308;S.C.                ;S.C.                ;           0;           0;          1;Terminales                                        ;NOK 630                                           
2015-11-16;         47;Nokia                                             ;Smarthphones y Masivos;                1;           0;                 0;               0;           1;S.C.                ;S.C.                ;           0;           0;          1;Terminales                                        ;NOK C1-01                                         
2015-11-16;         47;Nokia                                             ;Smarthphones y Masivos;                3;           7;                 0;               7;          10;S.C.                ;S.C.                ;           0;           0;          1;Terminales                                        ;NOK C2-02                                         
2015-11-16;         47;Nokia                                             ;Smarthphones y Masivos;                1;           9;                 0;               9;          10;S.C.                ;S.C.                ;           0;           0;          1;Terminales                                        ;NOK C3                                            
2015-11-16;         47;Nokia                                             ;Smarthphones y Masivos;                0;         219;                 0;             219;         219;S.C.                ;S.C.                ;           0;           0;          1;Terminales                                        ;NOK Lumia 435                                     
2015-11-16;         47;Nokia                                             ;Smarthphones y Masivos;              212;          67;                 2;              69;         281;S.C.                ;S.C.                ;           0;           0;          1;Terminales                                        ;NOK Lumia 635                                     
2015-11-16;         47;Nokia                                             ;Smarthphones y Masivos;                1;           0;                 1;               1;           2;S.C.                ;S.C.                ;           0;           0;          1;Terminales                                        ;NOK N710                                          
2015-11-16;         47;Nokia                                             ;Smarthphones y Masivos;                0;           3;                 0;               3;           3;S.C.                ;S.C.                ;           0;           0;          1;Terminales                                        ;NOK X2-01                                         
2015-11-17;         47;Nokia                                             ;iPhone y Premium      ;                2;           0;                 0;               0;           2;S.C.                ;S.C.                ;           0;           0;          2;Terminales                                        ;NOK 900                                           
2015-11-17;         47;Nokia                                             ;iPhone y Premium      ;                0;           1;                 1;               2;           2;S.C.                ;S.C.                ;           0;           0;          2;Terminales                                        ;NOK 925                                           
2015-11-17;         47;Nokia                                             ;iPhone y Premium      ;                1;           1;                 0;               1;           2;S.C.                ;S.C.                ;           0;           0;          2;Terminales                                        ;NOK N800                                          
2015-11-17;         47;Nokia                                             ;Smarthphones y Masivos;              774;         224;                 0;             224;         998;S.C.                ;S.C.                ;           0;           0;          2;Terminales                                        ;NOK 106                                           
2015-11-17;         47;Nokia                                             ;Smarthphones y Masivos;               39;          36;                 0;              36;          75;S.C.                ;S.C.                ;           0;           0;          2;Terminales                                        ;NOK 111                                           
2015-11-17;         47;Nokia                                             ;Smarthphones y Masivos;               35;          13;                 0;              13;          48;S.C.                ;S.C.                ;           0;           0;          2;Terminales                                        ;NOK 1320                                          
2015-11-17;         47;Nokia                                             ;Smarthphones y Masivos;                3;           2;                 0;               2;           5;S.C.                ;S.C.                ;           0;           0;          2;Terminales                                        ;NOK 210                                           
2015-11-17;         47;Nokia                                             ;Smarthphones y Masivos;            11269;        9556;               232;            9788;       21057;34,6                ;74,4                ;         323;         566;          2;Terminales                                        ;NOK 220                                           
2015-11-17;         47;Nokia                                             ;Smarthphones y Masivos;              131;           1;                 0;               1;         132;S.C.                ;S.C.                ;           0;           0;          2;Terminales                                        ;NOK 230                                           
2015-11-17;         47;Nokia                                             ;Smarthphones y Masivos;                1;           3;                 0;               3;           4;S.C.                ;S.C.                ;           0;           0;          2;Terminales                                        ;NOK 302                                           
2015-11-17;         47;Nokia                                             ;Smarthphones y Masivos;                0;           2;                 1;               3;           3;S.C.                ;S.C.                ;           0;           0;          2;Terminales                                        ;NOK 510                                           
2015-11-17;         47;Nokia                                             ;Smarthphones y Masivos;              116;         442;                 3;             445;         561;445,0               ;561,0               ;           2;           2;          2;Terminales                                        ;NOK 520                                           
2015-11-17;         47;Nokia                                             ;Smarthphones y Masivos;                1;           0;                 0;               0;           1;S.C.                ;S.C.                ;           0;           0;          2;Terminales                                        ;NOK 5230                                          
2015-11-17;         47;Nokia                                             ;Smarthphones y Masivos;                0;           1;                 0;               1;           1;S.C.                ;S.C.                ;           0;           0;          2;Terminales                                        ;NOK 610                                           
2015-11-17;         47;Nokia                                             ;Smarthphones y Masivos;              235;          52;                 1;              53;         288;S.C.                ;S.C.                ;           0;           0;          2;Terminales                                        ;NOK 630                                           
2015-11-17;         47;Nokia                                             ;Smarthphones y Masivos;                1;           0;                 0;               0;           1;S.C.                ;S.C.                ;           0;           0;          2;Terminales                                        ;NOK C1-01                                         
2015-11-17;         47;Nokia                                             ;Smarthphones y Masivos;                3;           7;                 0;               7;          10;S.C.                ;S.C.                ;           0;           0;          2;Terminales                                        ;NOK C2-02                                         
2015-11-17;         47;Nokia                                             ;Smarthphones y Masivos;                1;           9;                 0;               9;          10;S.C.                ;S.C.                ;           0;           0;          2;Terminales                                        ;NOK C3                                            
2015-11-17;         47;Nokia                                             ;Smarthphones y Masivos;                0;         218;                 0;             218;         218;436,0               ;436,0               ;           1;           1;          2;Terminales                                        ;NOK Lumia 435                                     
2015-11-17;         47;Nokia                                             ;Smarthphones y Masivos;              212;          64;                 0;              64;         276;S.C.                ;S.C.                ;           0;           0;          2;Terminales                                        ;NOK Lumia 635                                     
2015-11-17;         47;Nokia                                             ;Smarthphones y Masivos;                1;           0;                 1;               1;           2;S.C.                ;S.C.                ;           0;           0;          2;Terminales                                        ;NOK N710                                          
2015-11-17;         47;Nokia                                             ;Smarthphones y Masivos;                0;           3;                 0;               3;           3;S.C.                ;S.C.                ;           0;           0;          2;Terminales                                        ;NOK X2-01                                         
2015-11-18;         47;Nokia                                             ;iPhone y Premium      ;                2;           0;                 0;               0;           2;S.C.                ;S.C.                ;           0;           0;          3;Terminales                                        ;NOK 900                                           
2015-11-18;         47;Nokia                                             ;iPhone y Premium      ;                1;           1;                 1;               2;           3;S.C.                ;S.C.                ;           0;           0;          3;Terminales                                        ;NOK 925                                           
2015-11-18;         47;Nokia                                             ;iPhone y Premium      ;                1;           1;                 0;               1;           2;S.C.                ;S.C.                ;           0;           0;          3;Terminales                                        ;NOK N800                                          
2015-11-18;         47;Nokia                                             ;Smarthphones y Masivos;              774;         224;                 0;             224;         998;S.C.                ;S.C.                ;           0;           0;          3;Terminales                                        ;NOK 106                                           
2015-11-18;         47;Nokia                                             ;Smarthphones y Masivos;               39;          36;                 0;              36;          75;S.C.                ;S.C.                ;           0;           0;          3;Terminales                                        ;NOK 111                                           
2015-11-18;         47;Nokia                                             ;Smarthphones y Masivos;               36;          13;                 0;              13;          49;S.C.                ;S.C.                ;           0;           0;          3;Terminales                                        ;NOK 1320                                          
2015-11-18;         47;Nokia                                             ;Smarthphones y Masivos;                3;           2;                 0;               2;           5;S.C.                ;S.C.                ;           0;           0;          3;Terminales                                        ;NOK 210                                           
2015-11-18;         47;Nokia                                             ;Smarthphones y Masivos;            11001;        9165;               438;            9603;       20604;26,7                ;57,4                ;         511;        1077;          3;Terminales                                        ;NOK 220                                           
2015-11-18;         47;Nokia                                             ;Smarthphones y Masivos;              131;           1;                 0;               1;         132;S.C.                ;S.C.                ;           0;           0;          3;Terminales                                        ;NOK 230                                           
2015-11-18;         47;Nokia                                             ;Smarthphones y Masivos;                1;           2;                 0;               2;           3;S.C.                ;S.C.                ;           0;           0;          3;Terminales                                        ;NOK 302                                           
2015-11-18;         47;Nokia                                             ;Smarthphones y Masivos;                0;           2;                 1;               3;           3;S.C.                ;S.C.                ;           0;           0;          3;Terminales                                        ;NOK 510                                           
2015-11-18;         47;Nokia                                             ;Smarthphones y Masivos;              128;         440;                 3;             443;         571;332,3               ;428,3               ;           2;           4;          3;Terminales                                        ;NOK 520                                           
2015-11-18;         47;Nokia                                             ;Smarthphones y Masivos;                1;           0;                 0;               0;           1;S.C.                ;S.C.                ;           0;           0;          3;Terminales                                        ;NOK 5230                                          
2015-11-18;         47;Nokia                                             ;Smarthphones y Masivos;                0;           1;                 0;               1;           1;S.C.                ;S.C.                ;           0;           0;          3;Terminales                                        ;NOK 610                                           
2015-11-18;         47;Nokia                                             ;Smarthphones y Masivos;              239;          52;                 1;              53;         292;S.C.                ;S.C.                ;           0;           0;          3;Terminales                                        ;NOK 630                                           
2015-11-18;         47;Nokia                                             ;Smarthphones y Masivos;                1;           0;                 0;               0;           1;S.C.                ;S.C.                ;           0;           0;          3;Terminales                                        ;NOK C1-01                                         
2015-11-18;         47;Nokia                                             ;Smarthphones y Masivos;                3;           7;                 0;               7;          10;S.C.                ;S.C.                ;           0;           0;          3;Terminales                                        ;NOK C2-02                                         
2015-11-18;         47;Nokia                                             ;Smarthphones y Masivos;                1;           9;                 0;               9;          10;S.C.                ;S.C.                ;           0;           0;          3;Terminales                                        ;NOK C3                                            
2015-11-18;         47;Nokia                                             ;Smarthphones y Masivos;                0;         218;                 0;             218;         218;654,0               ;654,0               ;           0;           1;          3;Terminales                                        ;NOK Lumia 435                                     
2015-11-18;         47;Nokia                                             ;Smarthphones y Masivos;              221;         109;                 0;             109;         330;81,8                ;247,5               ;           4;           4;          3;Terminales                                        ;NOK Lumia 635                                     
2015-11-18;         47;Nokia                                             ;Smarthphones y Masivos;                1;           0;                 1;               1;           2;S.C.                ;S.C.                ;           0;           0;          3;Terminales                                        ;NOK N710                                          
2015-11-18;         47;Nokia                                             ;Smarthphones y Masivos;                0;           3;                 0;               3;           3;S.C.                ;S.C.                ;           0;           0;          3;Terminales                                        ;NOK X2-01                                         
2015-11-19;         47;Nokia                                             ;iPhone y Premium      ;                2;           0;                 0;               0;           2;S.C.                ;S.C.                ;           0;           0;          4;Terminales                                        ;NOK 900                                           
2015-11-19;         47;Nokia                                             ;iPhone y Premium      ;                1;           1;                 1;               2;           3;S.C.                ;S.C.                ;           0;           0;          4;Terminales                                        ;NOK 925                                           
2015-11-19;         47;Nokia                                             ;iPhone y Premium      ;                1;           1;                 0;               1;           2;S.C.                ;S.C.                ;           0;           0;          4;Terminales                                        ;NOK N800                                          
2015-11-19;         47;Nokia                                             ;Smarthphones y Masivos;              774;         224;                 0;             224;         998;S.C.                ;S.C.                ;           0;           0;          4;Terminales                                        ;NOK 106                                           
2015-11-19;         47;Nokia                                             ;Smarthphones y Masivos;               39;          36;                 0;              36;          75;S.C.                ;S.C.                ;           0;           0;          4;Terminales                                        ;NOK 111                                           
2015-11-19;         47;Nokia                                             ;Smarthphones y Masivos;               36;          13;                 0;              13;          49;S.C.                ;S.C.                ;           0;           0;          4;Terminales                                        ;NOK 1320                                          
2015-11-19;         47;Nokia                                             ;Smarthphones y Masivos;                3;           2;                 0;               2;           5;S.C.                ;S.C.                ;           0;           0;          4;Terminales                                        ;NOK 210                                           
2015-11-19;         47;Nokia                                             ;Smarthphones y Masivos;            10886;        8858;               502;            9360;       20246;26,3                ;56,8                ;         349;        1426;          4;Terminales                                        ;NOK 220                                           
2015-11-19;         47;Nokia                                             ;Smarthphones y Masivos;              131;           1;                 0;               1;         132;S.C.                ;S.C.                ;           0;           0;          4;Terminales                                        ;NOK 230                                           
2015-11-19;         47;Nokia                                             ;Smarthphones y Masivos;                1;           2;                 0;               2;           3;S.C.                ;S.C.                ;           0;           0;          4;Terminales                                        ;NOK 302                                           
2015-11-19;         47;Nokia                                             ;Smarthphones y Masivos;                0;           2;                 1;               3;           3;S.C.                ;S.C.                ;           0;           0;          4;Terminales                                        ;NOK 510                                           
2015-11-19;         47;Nokia                                             ;Smarthphones y Masivos;              128;         439;                 3;             442;         570;442,0               ;570,0               ;           0;           4;          4;Terminales                                        ;NOK 520                                           
2015-11-19;         47;Nokia                                             ;Smarthphones y Masivos;                1;           0;                 0;               0;           1;S.C.                ;S.C.                ;           0;           0;          4;Terminales                                        ;NOK 5230                                          
2015-11-19;         47;Nokia                                             ;Smarthphones y Masivos;                0;           1;                 0;               1;           1;S.C.                ;S.C.                ;           0;           0;          4;Terminales                                        ;NOK 610                                           
2015-11-19;         47;Nokia                                             ;Smarthphones y Masivos;              239;          51;                 1;              52;         291;S.C.                ;S.C.                ;           0;           0;          4;Terminales                                        ;NOK 630                                           
2015-11-19;         47;Nokia                                             ;Smarthphones y Masivos;                1;           0;                 0;               0;           1;S.C.                ;S.C.                ;           0;           0;          4;Terminales                                        ;NOK C1-01                                         
2015-11-19;         47;Nokia                                             ;Smarthphones y Masivos;                3;           7;                 0;               7;          10;S.C.                ;S.C.                ;           0;           0;          4;Terminales                                        ;NOK C2-02                                         
2015-11-19;         47;Nokia                                             ;Smarthphones y Masivos;                1;           9;                 0;               9;          10;S.C.                ;S.C.                ;           0;           0;          4;Terminales                                        ;NOK C3                                            
2015-11-19;         47;Nokia                                             ;Smarthphones y Masivos;                0;         218;                 0;             218;         218;872,0               ;872,0               ;           0;           1;          4;Terminales                                        ;NOK Lumia 435                                     
2015-11-19;         47;Nokia                                             ;Smarthphones y Masivos;              221;         109;                 0;             109;         330;109,0               ;330,0               ;           0;           4;          4;Terminales                                        ;NOK Lumia 635                                     
2015-11-19;         47;Nokia                                             ;Smarthphones y Masivos;                1;           0;                 1;               1;           2;S.C.                ;S.C.                ;           0;           0;          4;Terminales                                        ;NOK N710                                          
2015-11-19;         47;Nokia                                             ;Smarthphones y Masivos;                0;           3;                 0;               3;           3;S.C.                ;S.C.                ;           0;           0;          4;Terminales                                        ;NOK X2-01                                         
2015-11-20;         47;Nokia                                             ;Smarthphones y Masivos;                0;           0;                 0;               0;           0;0,0                 ;0,0                 ;         340;        1766;          5;Terminales                                        ;NOK 220                                           
2015-11-20;         47;Nokia                                             ;Smarthphones y Masivos;                0;           0;                 0;               0;           0;0,0                 ;0,0                 ;          10;          14;          5;Terminales                                        ;NOK 520                                           
2015-11-20;         47;Nokia                                             ;Smarthphones y Masivos;                0;           0;                 0;               0;           0;0,0                 ;0,0                 ;           0;           1;          5;Terminales                                        ;NOK Lumia 435                                     
2015-11-20;         47;Nokia                                             ;Smarthphones y Masivos;                0;           0;                 0;               0;           0;0,0                 ;0,0                 ;          50;          54;          5;Terminales                                        ;NOK Lumia 635                                     
2015-11-21;         47;Nokia                                             ;Smarthphones y Masivos;                0;           0;                 0;               0;           0;0,0                 ;0,0                 ;          28;        1794;          6;Terminales                                        ;NOK 220                                           
2015-11-21;         47;Nokia                                             ;Smarthphones y Masivos;                0;           0;                 0;               0;           0;0,0                 ;0,0                 ;           0;          14;          6;Terminales                                        ;NOK 520                                           
2015-11-21;         47;Nokia                                             ;Smarthphones y Masivos;                0;           0;                 0;               0;           0;0,0                 ;0,0                 ;           0;           1;          6;Terminales                                        ;NOK Lumia 435                                     
2015-11-21;         47;Nokia                                             ;Smarthphones y Masivos;                0;           0;                 0;               0;           0;0,0                 ;0,0                 ;           0;          54;          6;Terminales                                        ;NOK Lumia 635                                     
2015-11-22;         47;Nokia                                             ;iPhone y Premium      ;                2;           0;                 0;               0;           2;S.C.                ;S.C.                ;           0;           0;          7;Terminales                                        ;NOK 900                                           
2015-11-22;         47;Nokia                                             ;iPhone y Premium      ;                1;           1;                 1;               2;           3;S.C.                ;S.C.                ;           0;           0;          7;Terminales                                        ;NOK 925                                           
2015-11-22;         47;Nokia                                             ;iPhone y Premium      ;                1;           1;                 0;               1;           2;S.C.                ;S.C.                ;           0;           0;          7;Terminales                                        ;NOK N800                                          
2015-11-22;         47;Nokia                                             ;Smarthphones y Masivos;              774;         224;                 0;             224;         998;S.C.                ;S.C.                ;           0;           0;          7;Terminales                                        ;NOK 106                                           
2015-11-22;         47;Nokia                                             ;Smarthphones y Masivos;               39;          36;                 0;              36;          75;S.C.                ;S.C.                ;           0;           0;          7;Terminales                                        ;NOK 111                                           
2015-11-22;         47;Nokia                                             ;Smarthphones y Masivos;               36;          13;                 0;              13;          49;S.C.                ;S.C.                ;           0;           0;          7;Terminales                                        ;NOK 1320                                          
2015-11-22;         47;Nokia                                             ;Smarthphones y Masivos;                3;           2;                 0;               2;           5;S.C.                ;S.C.                ;           0;           0;          7;Terminales                                        ;NOK 210                                           
2015-11-22;         47;Nokia                                             ;Smarthphones y Masivos;             9715;        8806;              1353;           10159;       19874;39,4                ;77,2                ;           9;        1803;          7;Terminales                                        ;NOK 220                                           
2015-11-22;         47;Nokia                                             ;Smarthphones y Masivos;              131;           1;                 0;               1;         132;S.C.                ;S.C.                ;           0;           0;          7;Terminales                                        ;NOK 230                                           
2015-11-22;         47;Nokia                                             ;Smarthphones y Masivos;                1;           2;                 0;               2;           3;S.C.                ;S.C.                ;           0;           0;          7;Terminales                                        ;NOK 302                                           
2015-11-22;         47;Nokia                                             ;Smarthphones y Masivos;                0;           2;                 1;               3;           3;S.C.                ;S.C.                ;           0;           0;          7;Terminales                                        ;NOK 510                                           
2015-11-22;         47;Nokia                                             ;Smarthphones y Masivos;              128;         429;                 3;             432;         560;216,0               ;280,0               ;           0;          14;          7;Terminales                                        ;NOK 520                                           
2015-11-22;         47;Nokia                                             ;Smarthphones y Masivos;                1;           0;                 0;               0;           1;S.C.                ;S.C.                ;           0;           0;          7;Terminales                                        ;NOK 5230                                          
2015-11-22;         47;Nokia                                             ;Smarthphones y Masivos;                0;           1;                 0;               1;           1;S.C.                ;S.C.                ;           0;           0;          7;Terminales                                        ;NOK 610                                           
2015-11-22;         47;Nokia                                             ;Smarthphones y Masivos;              239;          51;                 1;              52;         291;S.C.                ;S.C.                ;           0;           0;          7;Terminales                                        ;NOK 630                                           
2015-11-22;         47;Nokia                                             ;Smarthphones y Masivos;                1;           0;                 0;               0;           1;S.C.                ;S.C.                ;           0;           0;          7;Terminales                                        ;NOK C1-01                                         
2015-11-22;         47;Nokia                                             ;Smarthphones y Masivos;                3;           7;                 0;               7;          10;S.C.                ;S.C.                ;           0;           0;          7;Terminales                                        ;NOK C2-02                                         
2015-11-22;         47;Nokia                                             ;Smarthphones y Masivos;                1;           9;                 0;               9;          10;S.C.                ;S.C.                ;           0;           0;          7;Terminales                                        ;NOK C3                                            
2015-11-22;         47;Nokia                                             ;Smarthphones y Masivos;                0;         218;                 0;             218;         218;1526,0              ;1526,0              ;           0;           1;          7;Terminales                                        ;NOK Lumia 435                                     
2015-11-22;         47;Nokia                                             ;Smarthphones y Masivos;              221;          58;                 1;              59;         280;7,6                 ;36,3                ;           0;          54;          7;Terminales                                        ;NOK Lumia 635                                     
2015-11-22;         47;Nokia                                             ;Smarthphones y Masivos;                1;           0;                 1;               1;           2;S.C.                ;S.C.                ;           0;           0;          7;Terminales                                        ;NOK N710                                          
2015-11-22;         47;Nokia                                             ;Smarthphones y Masivos;                0;           3;                 0;               3;           3;S.C.                ;S.C.                ;           0;           0;          7;Terminales                                        ;NOK X2-01                                         
2015-11-23;         48;Nokia                                             ;iPhone y Premium      ;                2;           0;                 0;               0;           2;S.C.                ;S.C.                ;           0;           0;          1;Terminales                                        ;NOK 900                                           
2015-11-23;         48;Nokia                                             ;iPhone y Premium      ;                1;           1;                 1;               2;           3;S.C.                ;S.C.                ;           0;           0;          1;Terminales                                        ;NOK 925                                           
2015-11-23;         48;Nokia                                             ;iPhone y Premium      ;                1;           1;                 0;               1;           2;S.C.                ;S.C.                ;           0;           0;          1;Terminales                                        ;NOK N800                                          
2015-11-23;         48;Nokia                                             ;Smarthphones y Masivos;              774;         224;                 0;             224;         998;S.C.                ;S.C.                ;           0;           0;          1;Terminales                                        ;NOK 106                                           
2015-11-23;         48;Nokia                                             ;Smarthphones y Masivos;               39;          36;                 0;              36;          75;S.C.                ;S.C.                ;           0;           0;          1;Terminales                                        ;NOK 111                                           
2015-11-23;         48;Nokia                                             ;Smarthphones y Masivos;               36;          13;                 0;              13;          49;S.C.                ;S.C.                ;           0;           0;          1;Terminales                                        ;NOK 1320                                          
2015-11-23;         48;Nokia                                             ;Smarthphones y Masivos;                3;           2;                 0;               2;           5;S.C.                ;S.C.                ;           0;           0;          1;Terminales                                        ;NOK 210                                           
2015-11-23;         48;Nokia                                             ;Smarthphones y Masivos;             9665;        9607;               351;            9958;       19623;37,3                ;73,5                ;         267;         267;          1;Terminales                                        ;NOK 220                                           
2015-11-23;         48;Nokia                                             ;Smarthphones y Masivos;              131;           1;                 0;               1;         132;S.C.                ;S.C.                ;           0;           0;          1;Terminales                                        ;NOK 230                                           
2015-11-23;         48;Nokia                                             ;Smarthphones y Masivos;                1;           2;                 0;               2;           3;S.C.                ;S.C.                ;           0;           0;          1;Terminales                                        ;NOK 302                                           
2015-11-23;         48;Nokia                                             ;Smarthphones y Masivos;                0;           2;                 1;               3;           3;S.C.                ;S.C.                ;           0;           0;          1;Terminales                                        ;NOK 510                                           
2015-11-23;         48;Nokia                                             ;Smarthphones y Masivos;              130;         431;                 1;             432;         562;S.C.                ;S.C.                ;           0;           0;          1;Terminales                                        ;NOK 520                                           
2015-11-23;         48;Nokia                                             ;Smarthphones y Masivos;                1;           0;                 0;               0;           1;S.C.                ;S.C.                ;           0;           0;          1;Terminales                                        ;NOK 5230                                          
2015-11-23;         48;Nokia                                             ;Smarthphones y Masivos;                0;           1;                 0;               1;           1;S.C.                ;S.C.                ;           0;           0;          1;Terminales                                        ;NOK 610                                           
2015-11-23;         48;Nokia                                             ;Smarthphones y Masivos;              252;          51;                 1;              52;         304;S.C.                ;S.C.                ;           0;           0;          1;Terminales                                        ;NOK 630                                           
2015-11-23;         48;Nokia                                             ;Smarthphones y Masivos;                1;           0;                 0;               0;           1;S.C.                ;S.C.                ;           0;           0;          1;Terminales                                        ;NOK C1-01                                         
2015-11-23;         48;Nokia                                             ;Smarthphones y Masivos;                3;           7;                 0;               7;          10;S.C.                ;S.C.                ;           0;           0;          1;Terminales                                        ;NOK C2-02                                         
2015-11-23;         48;Nokia                                             ;Smarthphones y Masivos;                1;           9;                 0;               9;          10;S.C.                ;S.C.                ;           0;           0;          1;Terminales                                        ;NOK C3                                            
2015-11-23;         48;Nokia                                             ;Smarthphones y Masivos;                0;         217;                 0;             217;         217;217,0               ;217,0               ;           1;           1;          1;Terminales                                        ;NOK Lumia 435                                     
2015-11-23;         48;Nokia                                             ;Smarthphones y Masivos;              240;          59;                 1;              60;         300;S.C.                ;S.C.                ;           0;           0;          1;Terminales                                        ;NOK Lumia 635                                     
2015-11-23;         48;Nokia                                             ;Smarthphones y Masivos;                1;           0;                 1;               1;           2;S.C.                ;S.C.                ;           0;           0;          1;Terminales                                        ;NOK N710                                          
2015-11-23;         48;Nokia                                             ;Smarthphones y Masivos;                0;           3;                 0;               3;           3;S.C.                ;S.C.                ;           0;           0;          1;Terminales                                        ;NOK X2-01                                         
2015-11-24;         48;Nokia                                             ;iPhone y Premium      ;                2;           0;                 0;               0;           2;S.C.                ;S.C.                ;           0;           0;          2;Terminales                                        ;NOK 900                                           
2015-11-24;         48;Nokia                                             ;iPhone y Premium      ;                1;           1;                 1;               2;           3;S.C.                ;S.C.                ;           0;           0;          2;Terminales                                        ;NOK 925                                           
2015-11-24;         48;Nokia                                             ;iPhone y Premium      ;                1;           1;                 0;               1;           2;S.C.                ;S.C.                ;           0;           0;          2;Terminales                                        ;NOK N800                                          
2015-11-24;         48;Nokia                                             ;Smarthphones y Masivos;              774;         174;                 0;             174;         948;7,0                 ;37,9                ;          50;          50;          2;Terminales                                        ;NOK 106                                           
2015-11-24;         48;Nokia                                             ;Smarthphones y Masivos;               39;          48;                 0;              48;          87;S.C.                ;S.C.                ;           0;           0;          2;Terminales                                        ;NOK 111                                           
2015-11-24;         48;Nokia                                             ;Smarthphones y Masivos;               36;          13;                 0;              13;          49;S.C.                ;S.C.                ;           0;           0;          2;Terminales                                        ;NOK 1320                                          
2015-11-24;         48;Nokia                                             ;Smarthphones y Masivos;                3;           2;                 0;               2;           5;S.C.                ;S.C.                ;           0;           0;          2;Terminales                                        ;NOK 210                                           
2015-11-24;         48;Nokia                                             ;Smarthphones y Masivos;             9107;        9518;               673;           10191;       19298;31,6                ;59,8                ;         378;         645;          2;Terminales                                        ;NOK 220                                           
2015-11-24;         48;Nokia                                             ;Smarthphones y Masivos;              131;           1;                 0;               1;         132;S.C.                ;S.C.                ;           0;           0;          2;Terminales                                        ;NOK 230                                           
2015-11-24;         48;Nokia                                             ;Smarthphones y Masivos;                1;           2;                 0;               2;           3;S.C.                ;S.C.                ;           0;           0;          2;Terminales                                        ;NOK 302                                           
2015-11-24;         48;Nokia                                             ;Smarthphones y Masivos;                0;           2;                 1;               3;           3;S.C.                ;S.C.                ;           0;           0;          2;Terminales                                        ;NOK 510                                           
2015-11-24;         48;Nokia                                             ;Smarthphones y Masivos;              130;         437;                 1;             438;         568;-876,0              ;-1136,0             ;          -1;          -1;          2;Terminales                                        ;NOK 520                                           
2015-11-24;         48;Nokia                                             ;Smarthphones y Masivos;                1;           0;                 0;               0;           1;S.C.                ;S.C.                ;           0;           0;          2;Terminales                                        ;NOK 5230                                          
2015-11-24;         48;Nokia                                             ;Smarthphones y Masivos;                0;           1;                 0;               1;           1;S.C.                ;S.C.                ;           0;           0;          2;Terminales                                        ;NOK 610                                           
2015-11-24;         48;Nokia                                             ;Smarthphones y Masivos;              252;          76;                 1;              77;         329;S.C.                ;S.C.                ;           0;           0;          2;Terminales                                        ;NOK 630                                           
2015-11-24;         48;Nokia                                             ;Smarthphones y Masivos;                1;           0;                 0;               0;           1;S.C.                ;S.C.                ;           0;           0;          2;Terminales                                        ;NOK C1-01                                         
2015-11-24;         48;Nokia                                             ;Smarthphones y Masivos;                3;           7;                 0;               7;          10;S.C.                ;S.C.                ;           0;           0;          2;Terminales                                        ;NOK C2-02                                         
2015-11-24;         48;Nokia                                             ;Smarthphones y Masivos;                1;           9;                 0;               9;          10;S.C.                ;S.C.                ;           0;           0;          2;Terminales                                        ;NOK C3                                            
2015-11-24;         48;Nokia                                             ;Smarthphones y Masivos;                0;         217;                 0;             217;         217;434,0               ;434,0               ;           0;           1;          2;Terminales                                        ;NOK Lumia 435                                     
2015-11-24;         48;Nokia                                             ;Smarthphones y Masivos;              240;          78;                 1;              79;         319;S.C.                ;S.C.                ;           0;           0;          2;Terminales                                        ;NOK Lumia 635                                     
2015-11-24;         48;Nokia                                             ;Smarthphones y Masivos;                1;           0;                 1;               1;           2;S.C.                ;S.C.                ;           0;           0;          2;Terminales                                        ;NOK N710                                          
2015-11-24;         48;Nokia                                             ;Smarthphones y Masivos;                0;           3;                 0;               3;           3;S.C.                ;S.C.                ;           0;           0;          2;Terminales                                        ;NOK X2-01                                         
2015-11-25;         48;Nokia                                             ;iPhone y Premium      ;                2;           0;                 0;               0;           2;S.C.                ;S.C.                ;           0;           0;          3;Terminales                                        ;NOK 900                                           
2015-11-25;         48;Nokia                                             ;iPhone y Premium      ;                1;           1;                 1;               2;           3;S.C.                ;S.C.                ;           0;           0;          3;Terminales                                        ;NOK 925                                           
2015-11-25;         48;Nokia                                             ;iPhone y Premium      ;                1;           1;                 0;               1;           2;S.C.                ;S.C.                ;           0;           0;          3;Terminales                                        ;NOK N800                                          
2015-11-25;         48;Nokia                                             ;Smarthphones y Masivos;              774;         174;                 0;             174;         948;10,4                ;56,9                ;           0;          50;          3;Terminales                                        ;NOK 106                                           
2015-11-25;         48;Nokia                                             ;Smarthphones y Masivos;               39;          48;                 0;              48;          87;S.C.                ;S.C.                ;           0;           0;          3;Terminales                                        ;NOK 111                                           
2015-11-25;         48;Nokia                                             ;Smarthphones y Masivos;               36;          13;                 0;              13;          49;S.C.                ;S.C.                ;           0;           0;          3;Terminales                                        ;NOK 1320                                          
2015-11-25;         48;Nokia                                             ;Smarthphones y Masivos;                3;           2;                 0;               2;           5;S.C.                ;S.C.                ;           0;           0;          3;Terminales                                        ;NOK 210                                           
2015-11-25;         48;Nokia                                             ;Smarthphones y Masivos;             8520;        9262;              1176;           10438;       18958;32,0                ;58,0                ;         335;         980;          3;Terminales                                        ;NOK 220                                           
2015-11-25;         48;Nokia                                             ;Smarthphones y Masivos;              131;           1;                 0;               1;         132;S.C.                ;S.C.                ;           0;           0;          3;Terminales                                        ;NOK 230                                           
2015-11-25;         48;Nokia                                             ;Smarthphones y Masivos;                1;           2;                 0;               2;           3;S.C.                ;S.C.                ;           0;           0;          3;Terminales                                        ;NOK 302                                           
2015-11-25;         48;Nokia                                             ;Smarthphones y Masivos;                0;           2;                 1;               3;           3;S.C.                ;S.C.                ;           0;           0;          3;Terminales                                        ;NOK 510                                           
2015-11-25;         48;Nokia                                             ;Smarthphones y Masivos;              130;         437;                 1;             438;         568;-1314,0             ;-1704,0             ;           0;          -1;          3;Terminales                                        ;NOK 520                                           
2015-11-25;         48;Nokia                                             ;Smarthphones y Masivos;                1;           0;                 0;               0;           1;S.C.                ;S.C.                ;           0;           0;          3;Terminales                                        ;NOK 5230                                          
2015-11-25;         48;Nokia                                             ;Smarthphones y Masivos;                0;           1;                 0;               1;           1;S.C.                ;S.C.                ;           0;           0;          3;Terminales                                        ;NOK 610                                           
2015-11-25;         48;Nokia                                             ;Smarthphones y Masivos;              252;          76;                 1;              77;         329;S.C.                ;S.C.                ;           0;           0;          3;Terminales                                        ;NOK 630                                           
2015-11-25;         48;Nokia                                             ;Smarthphones y Masivos;                1;           0;                 0;               0;           1;S.C.                ;S.C.                ;           0;           0;          3;Terminales                                        ;NOK C1-01                                         
2015-11-25;         48;Nokia                                             ;Smarthphones y Masivos;                3;           7;                 0;               7;          10;S.C.                ;S.C.                ;           0;           0;          3;Terminales                                        ;NOK C2-02                                         
2015-11-25;         48;Nokia                                             ;Smarthphones y Masivos;                1;           9;                 0;               9;          10;S.C.                ;S.C.                ;           0;           0;          3;Terminales                                        ;NOK C3                                            
2015-11-25;         48;Nokia                                             ;Smarthphones y Masivos;                0;         217;                 0;             217;         217;651,0               ;651,0               ;           0;           1;          3;Terminales                                        ;NOK Lumia 435                                     
2015-11-25;         48;Nokia                                             ;Smarthphones y Masivos;              240;          78;                 1;              79;         319;S.C.                ;S.C.                ;           0;           0;          3;Terminales                                        ;NOK Lumia 635                                     
2015-11-25;         48;Nokia                                             ;Smarthphones y Masivos;                1;           0;                 1;               1;           2;S.C.                ;S.C.                ;           0;           0;          3;Terminales                                        ;NOK N710                                          
2015-11-25;         48;Nokia                                             ;Smarthphones y Masivos;                0;           3;                 0;               3;           3;S.C.                ;S.C.                ;           0;           0;          3;Terminales                                        ;NOK X2-01                                         
2015-11-26;         48;Nokia                                             ;iPhone y Premium      ;                2;           0;                 0;               0;           2;S.C.                ;S.C.                ;           0;           0;          4;Terminales                                        ;NOK 900                                           
2015-11-26;         48;Nokia                                             ;iPhone y Premium      ;                1;           2;                 0;               2;           3;S.C.                ;S.C.                ;           0;           0;          4;Terminales                                        ;NOK 925                                           
2015-11-26;         48;Nokia                                             ;iPhone y Premium      ;                1;           1;                 0;               1;           2;S.C.                ;S.C.                ;           0;           0;          4;Terminales                                        ;NOK N800                                          
2015-11-26;         48;Nokia                                             ;Smarthphones y Masivos;              774;         174;                 0;             174;         948;13,9                ;75,8                ;           0;          50;          4;Terminales                                        ;NOK 106                                           
2015-11-26;         48;Nokia                                             ;Smarthphones y Masivos;               39;          48;                 0;              48;          87;S.C.                ;S.C.                ;           0;           0;          4;Terminales                                        ;NOK 111                                           
2015-11-26;         48;Nokia                                             ;Smarthphones y Masivos;               36;          13;                 0;              13;          49;S.C.                ;S.C.                ;           0;           0;          4;Terminales                                        ;NOK 1320                                          
2015-11-26;         48;Nokia                                             ;Smarthphones y Masivos;                3;           2;                 0;               2;           5;S.C.                ;S.C.                ;           0;           0;          4;Terminales                                        ;NOK 210                                           
2015-11-26;         48;Nokia                                             ;Smarthphones y Masivos;             7297;        9235;              2060;           11295;       18592;33,6                ;55,3                ;         365;        1345;          4;Terminales                                        ;NOK 220                                           
2015-11-26;         48;Nokia                                             ;Smarthphones y Masivos;              131;           1;                 0;               1;         132;S.C.                ;S.C.                ;           0;           0;          4;Terminales                                        ;NOK 230                                           
2015-11-26;         48;Nokia                                             ;Smarthphones y Masivos;                1;           2;                 0;               2;           3;S.C.                ;S.C.                ;           0;           0;          4;Terminales                                        ;NOK 302                                           
2015-11-26;         48;Nokia                                             ;Smarthphones y Masivos;                0;           2;                 1;               3;           3;S.C.                ;S.C.                ;           0;           0;          4;Terminales                                        ;NOK 510                                           
2015-11-26;         48;Nokia                                             ;Smarthphones y Masivos;              130;         437;                 0;             437;         567;S.C.                ;S.C.                ;           1;           0;          4;Terminales                                        ;NOK 520                                           
2015-11-26;         48;Nokia                                             ;Smarthphones y Masivos;                1;           0;                 0;               0;           1;S.C.                ;S.C.                ;           0;           0;          4;Terminales                                        ;NOK 5230                                          
2015-11-26;         48;Nokia                                             ;Smarthphones y Masivos;                0;           1;                 0;               1;           1;S.C.                ;S.C.                ;           0;           0;          4;Terminales                                        ;NOK 610                                           
2015-11-26;         48;Nokia                                             ;Smarthphones y Masivos;              252;          76;                 0;              76;         328;304,0               ;1312,0              ;           1;           1;          4;Terminales                                        ;NOK 630                                           
2015-11-26;         48;Nokia                                             ;Smarthphones y Masivos;                1;           0;                 0;               0;           1;S.C.                ;S.C.                ;           0;           0;          4;Terminales                                        ;NOK C1-01                                         
2015-11-26;         48;Nokia                                             ;Smarthphones y Masivos;                3;           7;                 0;               7;          10;S.C.                ;S.C.                ;           0;           0;          4;Terminales                                        ;NOK C2-02                                         
2015-11-26;         48;Nokia                                             ;Smarthphones y Masivos;                1;           9;                 0;               9;          10;S.C.                ;S.C.                ;           0;           0;          4;Terminales                                        ;NOK C3                                            
2015-11-26;         48;Nokia                                             ;Smarthphones y Masivos;                0;         216;                 0;             216;         216;432,0               ;432,0               ;           1;           2;          4;Terminales                                        ;NOK Lumia 435                                     
2015-11-26;         48;Nokia                                             ;Smarthphones y Masivos;              240;          78;                 1;              79;         319;S.C.                ;S.C.                ;           0;           0;          4;Terminales                                        ;NOK Lumia 635                                     
2015-11-26;         48;Nokia                                             ;Smarthphones y Masivos;                1;           1;                 0;               1;           2;S.C.                ;S.C.                ;           0;           0;          4;Terminales                                        ;NOK N710                                          
2015-11-26;         48;Nokia                                             ;Smarthphones y Masivos;                0;           3;                 0;               3;           3;S.C.                ;S.C.                ;           0;           0;          4;Terminales                                        ;NOK X2-01                                         
2015-11-27;         48;Nokia                                             ;Smarthphones y Masivos;                0;           0;                 0;               0;           0;0,0                 ;0,0                 ;           0;          50;          5;Terminales                                        ;NOK 106                                           
2015-11-27;         48;Nokia                                             ;Smarthphones y Masivos;                0;           0;                 0;               0;           0;0,0                 ;0,0                 ;         337;        1682;          5;Terminales                                        ;NOK 220                                           
2015-11-27;         48;Nokia                                             ;Smarthphones y Masivos;                0;           0;                 0;               0;           0;S.C.                ;S.C.                ;           0;           0;          5;Terminales                                        ;NOK 520                                           
2015-11-27;         48;Nokia                                             ;Smarthphones y Masivos;                0;           0;                 0;               0;           0;0,0                 ;0,0                 ;           0;           1;          5;Terminales                                        ;NOK 630                                           
2015-11-27;         48;Nokia                                             ;Smarthphones y Masivos;                0;           0;                 0;               0;           0;0,0                 ;0,0                 ;           1;           3;          5;Terminales                                        ;NOK Lumia 435                                     
2015-11-27;         48;Nokia                                             ;Smarthphones y Masivos;                0;           0;                 0;               0;           0;0,0                 ;0,0                 ;           1;           1;          5;Terminales                                        ;NOK Lumia 635                                     
2015-11-28;         48;Nokia                                             ;Smarthphones y Masivos;                0;           0;                 0;               0;           0;0,0                 ;0,0                 ;           0;          50;          6;Terminales                                        ;NOK 106                                           
2015-11-28;         48;Nokia                                             ;Smarthphones y Masivos;                0;           0;                 0;               0;           0;0,0                 ;0,0                 ;          49;        1731;          6;Terminales                                        ;NOK 220                                           
2015-11-28;         48;Nokia                                             ;Smarthphones y Masivos;                0;           0;                 0;               0;           0;S.C.                ;S.C.                ;           0;           0;          6;Terminales                                        ;NOK 520                                           
2015-11-28;         48;Nokia                                             ;Smarthphones y Masivos;                0;           0;                 0;               0;           0;0,0                 ;0,0                 ;           0;           1;          6;Terminales                                        ;NOK 630                                           
2015-11-28;         48;Nokia                                             ;Smarthphones y Masivos;                0;           0;                 0;               0;           0;0,0                 ;0,0                 ;           0;           3;          6;Terminales                                        ;NOK Lumia 435                                     
2015-11-28;         48;Nokia                                             ;Smarthphones y Masivos;                0;           0;                 0;               0;           0;0,0                 ;0,0                 ;           0;           1;          6;Terminales                                        ;NOK Lumia 635                                     
2015-11-29;         48;Nokia                                             ;iPhone y Premium      ;                2;           0;                 0;               0;           2;S.C.                ;S.C.                ;           0;           0;          7;Terminales                                        ;NOK 900                                           
2015-11-29;         48;Nokia                                             ;iPhone y Premium      ;                1;           1;                 0;               1;           2;S.C.                ;S.C.                ;           0;           0;          7;Terminales                                        ;NOK 925                                           
2015-11-29;         48;Nokia                                             ;iPhone y Premium      ;                1;           1;                 0;               1;           2;S.C.                ;S.C.                ;           0;           0;          7;Terminales                                        ;NOK N800                                          
2015-11-29;         48;Nokia                                             ;Smarthphones y Masivos;              774;         174;                 0;             174;         948;24,4                ;132,7               ;           0;          50;          7;Terminales                                        ;NOK 106                                           
2015-11-29;         48;Nokia                                             ;Smarthphones y Masivos;               39;          40;                 0;              40;          79;S.C.                ;S.C.                ;           0;           0;          7;Terminales                                        ;NOK 111                                           
2015-11-29;         48;Nokia                                             ;Smarthphones y Masivos;               36;          13;                 0;              13;          49;S.C.                ;S.C.                ;           0;           0;          7;Terminales                                        ;NOK 1320                                          
2015-11-29;         48;Nokia                                             ;Smarthphones y Masivos;                3;           2;                 0;               2;           5;S.C.                ;S.C.                ;           0;           0;          7;Terminales                                        ;NOK 210                                           
2015-11-29;         48;Nokia                                             ;Smarthphones y Masivos;             7196;        9082;              1875;           10957;       18153;44,1                ;73,0                ;          10;        1741;          7;Terminales                                        ;NOK 220                                           
2015-11-29;         48;Nokia                                             ;Smarthphones y Masivos;              131;           1;                 0;               1;         132;S.C.                ;S.C.                ;           0;           0;          7;Terminales                                        ;NOK 230                                           
2015-11-29;         48;Nokia                                             ;Smarthphones y Masivos;                1;           2;                 0;               2;           3;S.C.                ;S.C.                ;           0;           0;          7;Terminales                                        ;NOK 302                                           
2015-11-29;         48;Nokia                                             ;Smarthphones y Masivos;                0;           2;                 1;               3;           3;S.C.                ;S.C.                ;           0;           0;          7;Terminales                                        ;NOK 510                                           
2015-11-29;         48;Nokia                                             ;Smarthphones y Masivos;              132;         437;                 0;             437;         569;S.C.                ;S.C.                ;           0;           0;          7;Terminales                                        ;NOK 520                                           
2015-11-29;         48;Nokia                                             ;Smarthphones y Masivos;                1;           0;                 0;               0;           1;S.C.                ;S.C.                ;           0;           0;          7;Terminales                                        ;NOK 5230                                          
2015-11-29;         48;Nokia                                             ;Smarthphones y Masivos;                0;           1;                 0;               1;           1;S.C.                ;S.C.                ;           0;           0;          7;Terminales                                        ;NOK 610                                           
2015-11-29;         48;Nokia                                             ;Smarthphones y Masivos;              256;          76;                 0;              76;         332;532,0               ;2324,0              ;           0;           1;          7;Terminales                                        ;NOK 630                                           
2015-11-29;         48;Nokia                                             ;Smarthphones y Masivos;                1;           0;                 0;               0;           1;S.C.                ;S.C.                ;           0;           0;          7;Terminales                                        ;NOK C1-01                                         
2015-11-29;         48;Nokia                                             ;Smarthphones y Masivos;                3;           7;                 0;               7;          10;S.C.                ;S.C.                ;           0;           0;          7;Terminales                                        ;NOK C2-02                                         
2015-11-29;         48;Nokia                                             ;Smarthphones y Masivos;                1;           9;                 0;               9;          10;S.C.                ;S.C.                ;           0;           0;          7;Terminales                                        ;NOK C3                                            
2015-11-29;         48;Nokia                                             ;Smarthphones y Masivos;                0;         215;                 0;             215;         215;501,7               ;501,7               ;           0;           3;          7;Terminales                                        ;NOK Lumia 435                                     
2015-11-29;         48;Nokia                                             ;Smarthphones y Masivos;              240;          77;                 2;              79;         319;553,0               ;2233,0              ;           0;           1;          7;Terminales                                        ;NOK Lumia 635                                     
2015-11-29;         48;Nokia                                             ;Smarthphones y Masivos;                1;           0;                 0;               0;           1;S.C.                ;S.C.                ;           0;           0;          7;Terminales                                        ;NOK N710                                          
2015-11-29;         48;Nokia                                             ;Smarthphones y Masivos;                0;           3;                 0;               3;           3;S.C.                ;S.C.                ;           0;           0;          7;Terminales                                        ;NOK X2-01                                         
2015-11-30;         49;Nokia                                             ;iPhone y Premium      ;                2;           0;                 0;               0;           2;S.C.                ;S.C.                ;           0;           0;          1;Terminales                                        ;NOK 900                                           
2015-11-30;         49;Nokia                                             ;iPhone y Premium      ;                1;           2;                 0;               2;           3;S.C.                ;S.C.                ;           0;           0;          1;Terminales                                        ;NOK 925                                           
2015-11-30;         49;Nokia                                             ;iPhone y Premium      ;                1;           1;                 0;               1;           2;S.C.                ;S.C.                ;           0;           0;          1;Terminales                                        ;NOK N800                                          
2015-11-30;         49;Nokia                                             ;Smarthphones y Masivos;              774;         173;                 0;             173;         947;173,0               ;947,0               ;           1;           1;          1;Terminales                                        ;NOK 106                                           
2015-11-30;         49;Nokia                                             ;Smarthphones y Masivos;               39;          40;                 0;              40;          79;S.C.                ;S.C.                ;           0;           0;          1;Terminales                                        ;NOK 111                                           
2015-11-30;         49;Nokia                                             ;Smarthphones y Masivos;               36;          12;                 0;              12;          48;12,0                ;48,0                ;           1;           1;          1;Terminales                                        ;NOK 1320                                          
2015-11-30;         49;Nokia                                             ;Smarthphones y Masivos;                3;           2;                 0;               2;           5;S.C.                ;S.C.                ;           0;           0;          1;Terminales                                        ;NOK 210                                           
2015-11-30;         49;Nokia                                             ;Smarthphones y Masivos;             6605;       10396;               861;           11257;       17862;39,0                ;61,8                ;         289;         289;          1;Terminales                                        ;NOK 220                                           
2015-11-30;         49;Nokia                                             ;Smarthphones y Masivos;              131;           1;                 0;               1;         132;S.C.                ;S.C.                ;           0;           0;          1;Terminales                                        ;NOK 230                                           
2015-11-30;         49;Nokia                                             ;Smarthphones y Masivos;                1;           2;                 0;               2;           3;S.C.                ;S.C.                ;           0;           0;          1;Terminales                                        ;NOK 302                                           
2015-11-30;         49;Nokia                                             ;Smarthphones y Masivos;                0;           2;                 1;               3;           3;S.C.                ;S.C.                ;           0;           0;          1;Terminales                                        ;NOK 510                                           
2015-11-30;         49;Nokia                                             ;Smarthphones y Masivos;              132;         435;                 0;             435;         567;S.C.                ;S.C.                ;           0;           0;          1;Terminales                                        ;NOK 520                                           
2015-11-30;         49;Nokia                                             ;Smarthphones y Masivos;                1;           0;                 0;               0;           1;S.C.                ;S.C.                ;           0;           0;          1;Terminales                                        ;NOK 5230                                          
2015-11-30;         49;Nokia                                             ;Smarthphones y Masivos;                0;           1;                 0;               1;           1;S.C.                ;S.C.                ;           0;           0;          1;Terminales                                        ;NOK 610                                           
2015-11-30;         49;Nokia                                             ;Smarthphones y Masivos;              256;          76;                 0;              76;         332;S.C.                ;S.C.                ;           0;           0;          1;Terminales                                        ;NOK 630                                           
2015-11-30;         49;Nokia                                             ;Smarthphones y Masivos;                1;           0;                 0;               0;           1;S.C.                ;S.C.                ;           0;           0;          1;Terminales                                        ;NOK C1-01                                         
2015-11-30;         49;Nokia                                             ;Smarthphones y Masivos;                3;           7;                 0;               7;          10;S.C.                ;S.C.                ;           0;           0;          1;Terminales                                        ;NOK C2-02                                         
2015-11-30;         49;Nokia                                             ;Smarthphones y Masivos;                1;           9;                 0;               9;          10;S.C.                ;S.C.                ;           0;           0;          1;Terminales                                        ;NOK C3                                            
2015-11-30;         49;Nokia                                             ;Smarthphones y Masivos;                0;         215;                 0;             215;         215;S.C.                ;S.C.                ;           0;           0;          1;Terminales                                        ;NOK Lumia 435                                     
2015-11-30;         49;Nokia                                             ;Smarthphones y Masivos;              240;          76;                 1;              77;         317;S.C.                ;S.C.                ;           0;           0;          1;Terminales                                        ;NOK Lumia 635                                     
2015-11-30;         49;Nokia                                             ;Smarthphones y Masivos;                1;           1;                 0;               1;           2;S.C.                ;S.C.                ;           0;           0;          1;Terminales                                        ;NOK N710                                          
2015-11-30;         49;Nokia                                             ;Smarthphones y Masivos;                0;           3;                 0;               3;           3;S.C.                ;S.C.                ;           0;           0;          1;Terminales                                        ;NOK X2-01                                         
2015-11-16;         47;OWN                                               ;Own                   ;            18866;           0;                 0;               0;       18866;S.C.                ;S.C.                ;           0;           0;          1;Terminales                                        ;OWN F1010                                         
2015-11-16;         47;OWN                                               ;Own                   ;                1;          31;                 3;              34;          35;S.C.                ;S.C.                ;           0;           0;          1;Terminales                                        ;OWN F1020                                         
2015-11-16;         47;OWN                                               ;Own                   ;             2592;           7;                 0;               7;        2599;S.C.                ;S.C.                ;           0;           0;          1;Terminales                                        ;OWN F1021                                         
2015-11-16;         47;OWN                                               ;Own                   ;               10;         173;                 0;             173;         183;86,5                ;91,5                ;           2;           2;          1;Terminales                                        ;OWN F1030                                         
2015-11-16;         47;OWN                                               ;Own                   ;               14;           5;                 2;               7;          21;S.C.                ;S.C.                ;           0;           0;          1;Terminales                                        ;OWN F2020                                         
2015-11-16;         47;OWN                                               ;Own                   ;             6197;        3773;               313;            4086;       10283;45,4                ;114,3               ;          90;          90;          1;Terminales                                        ;OWN Fun                                           
2015-11-16;         47;OWN                                               ;Own                   ;            14809;        1760;              1636;            3396;       18205;121,3               ;650,2               ;          28;          28;          1;Terminales                                        ;OWN S3010                                         
2015-11-16;         47;OWN                                               ;Own                   ;              150;        2943;               664;            3607;        3757;23,3                ;24,2                ;         155;         155;          1;Terminales                                        ;OWN S3015                                         
2015-11-16;         47;OWN                                               ;Own                   ;              197;         948;                11;             959;        1156;479,5               ;578,0               ;           2;           2;          1;Terminales                                        ;OWN S3030                                         
2015-11-16;         47;OWN                                               ;Own                   ;              286;          46;                 1;              47;         333;47,0                ;333,0               ;           1;           1;          1;Terminales                                        ;OWN S4010                                         
2015-11-16;         47;OWN                                               ;Own                   ;              136;        1086;                 1;            1087;        1223;271,8               ;305,8               ;           4;           4;          1;Terminales                                        ;OWN S4025                                         
2015-11-16;         47;OWN                                               ;Own                   ;            12735;           0;                 0;               0;       12735;S.C.                ;S.C.                ;           0;           0;          1;Terminales                                        ;OWN S4035                                         
2015-11-16;         47;OWN                                               ;Own                   ;              108;          22;                 0;              22;         130;S.C.                ;S.C.                ;           0;           0;          1;Terminales                                        ;OWN S4040                                         
2015-11-16;         47;OWN                                               ;Own                   ;               40;           6;                 2;               8;          48;S.C.                ;S.C.                ;           0;           0;          1;Terminales                                        ;OWN S5010                                         
2015-11-16;         47;OWN                                               ;Own                   ;              109;        2881;                20;            2901;        3010;32,6                ;33,8                ;          89;          89;          1;Terminales                                        ;OWN S5030                                         
2015-11-16;         47;OWN                                               ;Own                   ;             1982;           0;                 0;               0;        1982;S.C.                ;S.C.                ;           0;           0;          1;Terminales                                        ;OWN Selfie                                        
2015-11-16;         47;OWN                                               ;Own                   ;             2365;           0;                 0;               0;        2365;S.C.                ;S.C.                ;           0;           0;          1;Terminales                                        ;OWN Style                                         
2015-11-17;         47;OWN                                               ;Own                   ;            18866;           0;                 0;               0;       18866;S.C.                ;S.C.                ;           0;           0;          2;Terminales                                        ;OWN F1010                                         
2015-11-17;         47;OWN                                               ;Own                   ;                1;          31;                 3;              34;          35;S.C.                ;S.C.                ;           0;           0;          2;Terminales                                        ;OWN F1020                                         
2015-11-17;         47;OWN                                               ;Own                   ;             1843;           7;                 0;               7;        1850;S.C.                ;S.C.                ;           0;           0;          2;Terminales                                        ;OWN F1021                                         
2015-11-17;         47;OWN                                               ;Own                   ;               10;         173;                 0;             173;         183;173,0               ;183,0               ;           0;           2;          2;Terminales                                        ;OWN F1030                                         
2015-11-17;         47;OWN                                               ;Own                   ;               14;           5;                 2;               7;          21;S.C.                ;S.C.                ;           0;           0;          2;Terminales                                        ;OWN F2020                                         
2015-11-17;         47;OWN                                               ;Own                   ;             8260;        3743;               325;            4068;       12328;62,1                ;188,2               ;          41;         131;          2;Terminales                                        ;OWN Fun                                           
2015-11-17;         47;OWN                                               ;Own                   ;            11914;        2942;               462;            3404;       15318;117,4               ;528,2               ;          30;          58;          2;Terminales                                        ;OWN S3010                                         
2015-11-17;         47;OWN                                               ;Own                   ;              150;        3210;               262;            3472;        3622;24,1                ;25,2                ;         133;         288;          2;Terminales                                        ;OWN S3015                                         
2015-11-17;         47;OWN                                               ;Own                   ;              197;         941;                11;             952;        1149;211,6               ;255,3               ;           7;           9;          2;Terminales                                        ;OWN S3030                                         
2015-11-17;         47;OWN                                               ;Own                   ;              286;          46;                 1;              47;         333;94,0                ;666,0               ;           0;           1;          2;Terminales                                        ;OWN S4010                                         
2015-11-17;         47;OWN                                               ;Own                   ;              136;        1077;                 2;            1079;        1215;215,8               ;243,0               ;           6;          10;          2;Terminales                                        ;OWN S4025                                         
2015-11-17;         47;OWN                                               ;Own                   ;            14544;           0;                 0;               0;       14544;S.C.                ;S.C.                ;           0;           0;          2;Terminales                                        ;OWN S4035                                         
2015-11-17;         47;OWN                                               ;Own                   ;              108;          22;                 0;              22;         130;S.C.                ;S.C.                ;           0;           0;          2;Terminales                                        ;OWN S4040                                         
2015-11-17;         47;OWN                                               ;Own                   ;               40;           6;                 2;               8;          48;S.C.                ;S.C.                ;           0;           0;          2;Terminales                                        ;OWN S5010                                         
2015-11-17;         47;OWN                                               ;Own                   ;               86;        2774;                43;            2817;        2903;30,6                ;31,6                ;          95;         184;          2;Terminales                                        ;OWN S5030                                         
2015-11-17;         47;OWN                                               ;Own                   ;             1975;           0;                 0;               0;        1975;S.C.                ;S.C.                ;           0;           0;          2;Terminales                                        ;OWN Selfie                                        
2015-11-17;         47;OWN                                               ;Own                   ;             2365;           0;                 0;               0;        2365;S.C.                ;S.C.                ;           0;           0;          2;Terminales                                        ;OWN Style                                         
2015-11-18;         47;OWN                                               ;Own                   ;            18866;           0;                 0;               0;       18866;S.C.                ;S.C.                ;           0;           0;          3;Terminales                                        ;OWN F1010                                         
2015-11-18;         47;OWN                                               ;Own                   ;                1;          31;                 3;              34;          35;S.C.                ;S.C.                ;           0;           0;          3;Terminales                                        ;OWN F1020                                         
2015-11-18;         47;OWN                                               ;Own                   ;              579;           7;                 0;               7;         586;S.C.                ;S.C.                ;           0;           0;          3;Terminales                                        ;OWN F1021                                         
2015-11-18;         47;OWN                                               ;Own                   ;               10;         172;                 0;             172;         182;172,0               ;182,0               ;           1;           3;          3;Terminales                                        ;OWN F1030                                         
2015-11-18;         47;OWN                                               ;Own                   ;               14;           4;                 2;               6;          20;S.C.                ;S.C.                ;           0;           0;          3;Terminales                                        ;OWN F2020                                         
2015-11-18;         47;OWN                                               ;Own                   ;            10621;        3695;               379;            4074;       14695;69,4                ;250,5               ;          45;         176;          3;Terminales                                        ;OWN Fun                                           
2015-11-18;         47;OWN                                               ;Own                   ;            11473;        3031;               356;            3387;       14860;119,5               ;524,5               ;          27;          85;          3;Terminales                                        ;OWN S3010                                         
2015-11-18;         47;OWN                                               ;Own                   ;              188;        3017;               241;            3258;        3446;21,5                ;22,7                ;         167;         455;          3;Terminales                                        ;OWN S3015                                         
2015-11-18;         47;OWN                                               ;Own                   ;              201;         940;                11;             951;        1152;259,4               ;314,2               ;           2;          11;          3;Terminales                                        ;OWN S3030                                         
2015-11-18;         47;OWN                                               ;Own                   ;              295;          46;                 1;              47;         342;141,0               ;1026,0              ;           0;           1;          3;Terminales                                        ;OWN S4010                                         
2015-11-18;         47;OWN                                               ;Own                   ;              138;        1070;                 1;            1071;        1209;189,0               ;213,4               ;           7;          17;          3;Terminales                                        ;OWN S4025                                         
2015-11-18;         47;OWN                                               ;Own                   ;            14064;           0;                 0;               0;       14064;S.C.                ;S.C.                ;           0;           0;          3;Terminales                                        ;OWN S4035                                         
2015-11-18;         47;OWN                                               ;Own                   ;              108;          22;                 0;              22;         130;S.C.                ;S.C.                ;           0;           0;          3;Terminales                                        ;OWN S4040                                         
2015-11-18;         47;OWN                                               ;Own                   ;               41;           6;                 2;               8;          49;S.C.                ;S.C.                ;           0;           0;          3;Terminales                                        ;OWN S5010                                         
2015-11-18;         47;OWN                                               ;Own                   ;               98;        2685;                39;            2724;        2822;29,9                ;31,0                ;          89;         273;          3;Terminales                                        ;OWN S5030                                         
2015-11-18;         47;OWN                                               ;Own                   ;             1975;           0;                 0;               0;        1975;S.C.                ;S.C.                ;           0;           0;          3;Terminales                                        ;OWN Selfie                                        
2015-11-18;         47;OWN                                               ;Own                   ;             2240;           0;                 0;               0;        2240;S.C.                ;S.C.                ;           0;           0;          3;Terminales                                        ;OWN Style                                         
2015-11-19;         47;OWN                                               ;Own                   ;            19262;           0;                 0;               0;       19262;S.C.                ;S.C.                ;           0;           0;          4;Terminales                                        ;OWN F1010                                         
2015-11-19;         47;OWN                                               ;Own                   ;                1;          31;                 3;              34;          35;S.C.                ;S.C.                ;           0;           0;          4;Terminales                                        ;OWN F1020                                         
2015-11-19;         47;OWN                                               ;Own                   ;              579;           7;                 0;               7;         586;S.C.                ;S.C.                ;           0;           0;          4;Terminales                                        ;OWN F1021                                         
2015-11-19;         47;OWN                                               ;Own                   ;               10;         172;                 1;             173;         183;230,7               ;244,0               ;           0;           3;          4;Terminales                                        ;OWN F1030                                         
2015-11-19;         47;OWN                                               ;Own                   ;               14;           5;                 1;               6;          20;S.C.                ;S.C.                ;           0;           0;          4;Terminales                                        ;OWN F2020                                         
2015-11-19;         47;OWN                                               ;Own                   ;            11125;        3959;                93;            4052;       15177;80,6                ;302,0               ;          25;         201;          4;Terminales                                        ;OWN Fun                                           
2015-11-19;         47;OWN                                               ;Own                   ;            11472;        3226;               104;            3330;       14802;97,9                ;435,4               ;          51;         136;          4;Terminales                                        ;OWN S3010                                         
2015-11-19;         47;OWN                                               ;Own                   ;              177;        2906;               194;            3100;        3277;19,0                ;20,1                ;         198;         653;          4;Terminales                                        ;OWN S3015                                         
2015-11-19;         47;OWN                                               ;Own                   ;              195;         937;                17;             954;        1149;318,0               ;383,0               ;           1;          12;          4;Terminales                                        ;OWN S3030                                         
2015-11-19;         47;OWN                                               ;Own                   ;              295;          46;                 1;              47;         342;188,0               ;1368,0              ;           0;           1;          4;Terminales                                        ;OWN S4010                                         
2015-11-19;         47;OWN                                               ;Own                   ;              138;        1066;                 3;            1069;        1207;237,6               ;268,2               ;           1;          18;          4;Terminales                                        ;OWN S4025                                         
2015-11-19;         47;OWN                                               ;Own                   ;             5652;           0;                40;              40;        5692;S.C.                ;S.C.                ;           0;           0;          4;Terminales                                        ;OWN S4035                                         
2015-11-19;         47;OWN                                               ;Own                   ;              108;          22;                 0;              22;         130;S.C.                ;S.C.                ;           0;           0;          4;Terminales                                        ;OWN S4040                                         
2015-11-19;         47;OWN                                               ;Own                   ;               41;           6;                 2;               8;          49;S.C.                ;S.C.                ;           0;           0;          4;Terminales                                        ;OWN S5010                                         
2015-11-19;         47;OWN                                               ;Own                   ;               97;        2607;                41;            2648;        2745;30,6                ;31,7                ;          73;         346;          4;Terminales                                        ;OWN S5030                                         
2015-11-19;         47;OWN                                               ;Own                   ;             1975;           0;                 0;               0;        1975;S.C.                ;S.C.                ;           0;           0;          4;Terminales                                        ;OWN Selfie                                        
2015-11-19;         47;OWN                                               ;Own                   ;             2360;           0;                 0;               0;        2360;S.C.                ;S.C.                ;           0;           0;          4;Terminales                                        ;OWN Style                                         
2015-11-20;         47;OWN                                               ;Own                   ;                0;           0;                 0;               0;           0;0,0                 ;0,0                 ;           0;           3;          5;Terminales                                        ;OWN F1030                                         
2015-11-20;         47;OWN                                               ;Own                   ;                0;           0;                 0;               0;           0;0,0                 ;0,0                 ;          39;         240;          5;Terminales                                        ;OWN Fun                                           
2015-11-20;         47;OWN                                               ;Own                   ;                0;           0;                 0;               0;           0;0,0                 ;0,0                 ;          81;         217;          5;Terminales                                        ;OWN S3010                                         
2015-11-20;         47;OWN                                               ;Own                   ;                0;           0;                 0;               0;           0;0,0                 ;0,0                 ;         151;         804;          5;Terminales                                        ;OWN S3015                                         
2015-11-20;         47;OWN                                               ;Own                   ;                0;           0;                 0;               0;           0;0,0                 ;0,0                 ;           8;          20;          5;Terminales                                        ;OWN S3030                                         
2015-11-20;         47;OWN                                               ;Own                   ;                0;           0;                 0;               0;           0;0,0                 ;0,0                 ;           0;           1;          5;Terminales                                        ;OWN S4010                                         
2015-11-20;         47;OWN                                               ;Own                   ;                0;           0;                 0;               0;           0;0,0                 ;0,0                 ;           6;          24;          5;Terminales                                        ;OWN S4025                                         
2015-11-20;         47;OWN                                               ;Own                   ;                0;           0;                 0;               0;           0;0,0                 ;0,0                 ;          78;         424;          5;Terminales                                        ;OWN S5030                                         
2015-11-21;         47;OWN                                               ;Own                   ;                0;           0;                 0;               0;           0;0,0                 ;0,0                 ;           0;           3;          6;Terminales                                        ;OWN F1030                                         
2015-11-21;         47;OWN                                               ;Own                   ;                0;           0;                 0;               0;           0;0,0                 ;0,0                 ;           7;         247;          6;Terminales                                        ;OWN Fun                                           
2015-11-21;         47;OWN                                               ;Own                   ;                0;           0;                 0;               0;           0;0,0                 ;0,0                 ;          12;         229;          6;Terminales                                        ;OWN S3010                                         
2015-11-21;         47;OWN                                               ;Own                   ;                0;           0;                 0;               0;           0;0,0                 ;0,0                 ;           1;         805;          6;Terminales                                        ;OWN S3015                                         
2015-11-21;         47;OWN                                               ;Own                   ;                0;           0;                 0;               0;           0;0,0                 ;0,0                 ;           0;          20;          6;Terminales                                        ;OWN S3030                                         
2015-11-21;         47;OWN                                               ;Own                   ;                0;           0;                 0;               0;           0;0,0                 ;0,0                 ;           0;           1;          6;Terminales                                        ;OWN S4010                                         
2015-11-21;         47;OWN                                               ;Own                   ;                0;           0;                 0;               0;           0;0,0                 ;0,0                 ;           1;          25;          6;Terminales                                        ;OWN S4025                                         
2015-11-21;         47;OWN                                               ;Own                   ;                0;           0;                 0;               0;           0;0,0                 ;0,0                 ;          25;         449;          6;Terminales                                        ;OWN S5030                                         
2015-11-22;         47;OWN                                               ;Own                   ;            19263;           0;                 0;               0;       19263;S.C.                ;S.C.                ;           0;           0;          7;Terminales                                        ;OWN F1010                                         
2015-11-22;         47;OWN                                               ;Own                   ;                1;          31;                 3;              34;          35;S.C.                ;S.C.                ;           0;           0;          7;Terminales                                        ;OWN F1020                                         
2015-11-22;         47;OWN                                               ;Own                   ;              579;           7;                 0;               7;         586;S.C.                ;S.C.                ;           0;           0;          7;Terminales                                        ;OWN F1021                                         
2015-11-22;         47;OWN                                               ;Own                   ;               10;         172;                 1;             173;         183;403,7               ;427,0               ;           0;           3;          7;Terminales                                        ;OWN F1030                                         
2015-11-22;         47;OWN                                               ;Own                   ;               14;           4;                 1;               5;          19;S.C.                ;S.C.                ;           0;           0;          7;Terminales                                        ;OWN F2020                                         
2015-11-22;         47;OWN                                               ;Own                   ;            11082;        3921;               120;            4041;       15123;114,1               ;426,9               ;           1;         248;          7;Terminales                                        ;OWN Fun                                           
2015-11-22;         47;OWN                                               ;Own                   ;            11452;        3187;                66;            3253;       14705;98,2                ;443,7               ;           3;         232;          7;Terminales                                        ;OWN S3010                                         
2015-11-22;         47;OWN                                               ;Own                   ;              177;        2770;               163;            2933;        3110;25,5                ;27,0                ;           0;         805;          7;Terminales                                        ;OWN S3015                                         
2015-11-22;         47;OWN                                               ;Own                   ;              202;         928;                16;             944;        1146;330,4               ;401,1               ;           0;          20;          7;Terminales                                        ;OWN S3030                                         
2015-11-22;         47;OWN                                               ;Own                   ;              295;          46;                 1;              47;         342;329,0               ;2394,0              ;           0;           1;          7;Terminales                                        ;OWN S4010                                         
2015-11-22;         47;OWN                                               ;Own                   ;               94;        1051;                46;            1097;        1191;284,4               ;308,8               ;           2;          27;          7;Terminales                                        ;OWN S4025                                         
2015-11-22;         47;OWN                                               ;Own                   ;             6286;           0;                40;              40;        6326;S.C.                ;S.C.                ;           0;           0;          7;Terminales                                        ;OWN S4035                                         
2015-11-22;         47;OWN                                               ;Own                   ;              108;          22;                 0;              22;         130;S.C.                ;S.C.                ;           0;           0;          7;Terminales                                        ;OWN S4040                                         
2015-11-22;         47;OWN                                               ;Own                   ;               41;           6;                 2;               8;          49;S.C.                ;S.C.                ;           0;           0;          7;Terminales                                        ;OWN S5010                                         
2015-11-22;         47;OWN                                               ;Own                   ;               97;        2492;                30;            2522;        2619;38,8                ;40,3                ;           6;         455;          7;Terminales                                        ;OWN S5030                                         
2015-11-22;         47;OWN                                               ;Own                   ;             1975;           0;                 0;               0;        1975;S.C.                ;S.C.                ;           0;           0;          7;Terminales                                        ;OWN Selfie                                        
2015-11-22;         47;OWN                                               ;Own                   ;             2360;           0;                 0;               0;        2360;S.C.                ;S.C.                ;           0;           0;          7;Terminales                                        ;OWN Style                                         
2015-11-23;         48;OWN                                               ;Own                   ;            15903;           0;                 0;               0;       15903;S.C.                ;S.C.                ;           0;           0;          1;Terminales                                        ;OWN F1010                                         
2015-11-23;         48;OWN                                               ;Own                   ;                1;          33;                 1;              34;          35;S.C.                ;S.C.                ;           0;           0;          1;Terminales                                        ;OWN F1020                                         
2015-11-23;         48;OWN                                               ;Own                   ;              579;           7;                 0;               7;         586;S.C.                ;S.C.                ;           0;           0;          1;Terminales                                        ;OWN F1021                                         
2015-11-23;         48;OWN                                               ;Own                   ;               10;         171;                 0;             171;         181;171,0               ;181,0               ;           1;           1;          1;Terminales                                        ;OWN F1030                                         
2015-11-23;         48;OWN                                               ;Own                   ;               14;           5;                 0;               5;          19;S.C.                ;S.C.                ;           0;           0;          1;Terminales                                        ;OWN F2020                                         
2015-11-23;         48;OWN                                               ;Own                   ;            14962;        3918;                99;            4017;       18979;68,1                ;321,7               ;          59;          59;          1;Terminales                                        ;OWN Fun                                           
2015-11-23;         48;OWN                                               ;Own                   ;            11539;        3147;                70;            3217;       14756;53,6                ;245,9               ;          60;          60;          1;Terminales                                        ;OWN S3010                                         
2015-11-23;         48;OWN                                               ;Own                   ;              198;        2629;               151;            2780;        2978;17,8                ;19,1                ;         156;         156;          1;Terminales                                        ;OWN S3015                                         
2015-11-23;         48;OWN                                               ;Own                   ;              202;         926;                15;             941;        1143;235,3               ;285,8               ;           4;           4;          1;Terminales                                        ;OWN S3030                                         
2015-11-23;         48;OWN                                               ;Own                   ;              289;          46;                 1;              47;         336;S.C.                ;S.C.                ;           0;           0;          1;Terminales                                        ;OWN S4010                                         
2015-11-23;         48;OWN                                               ;Own                   ;              101;        1043;                51;            1094;        1195;273,5               ;298,8               ;           4;           4;          1;Terminales                                        ;OWN S4025                                         
2015-11-23;         48;OWN                                               ;Own                   ;             4289;          30;                20;              50;        4339;S.C.                ;S.C.                ;           0;           0;          1;Terminales                                        ;OWN S4035                                         
2015-11-23;         48;OWN                                               ;Own                   ;             6250;           0;                 0;               0;        6250;S.C.                ;S.C.                ;           0;           0;          1;Terminales                                        ;OWN S4035 4G                                      
2015-11-23;         48;OWN                                               ;Own                   ;              108;          22;                 0;              22;         130;S.C.                ;S.C.                ;           0;           0;          1;Terminales                                        ;OWN S4040                                         
2015-11-23;         48;OWN                                               ;Own                   ;               41;           6;                 2;               8;          49;S.C.                ;S.C.                ;           0;           0;          1;Terminales                                        ;OWN S5010                                         
2015-11-23;         48;OWN                                               ;Own                   ;              105;        2375;                28;            2403;        2508;20,9                ;21,8                ;         115;         115;          1;Terminales                                        ;OWN S5030                                         
2015-11-23;         48;OWN                                               ;Own                   ;             1975;           0;                 0;               0;        1975;S.C.                ;S.C.                ;           0;           0;          1;Terminales                                        ;OWN Selfie                                        
2015-11-23;         48;OWN                                               ;Own                   ;              125;           0;                 0;               0;         125;S.C.                ;S.C.                ;           0;           0;          1;Terminales                                        ;OWN Style                                         
2015-11-24;         48;OWN                                               ;Own                   ;            15903;           0;                 0;               0;       15903;S.C.                ;S.C.                ;           0;           0;          2;Terminales                                        ;OWN F1010                                         
2015-11-24;         48;OWN                                               ;Own                   ;                1;          33;                 1;              34;          35;S.C.                ;S.C.                ;           0;           0;          2;Terminales                                        ;OWN F1020                                         
2015-11-24;         48;OWN                                               ;Own                   ;            16579;           7;                 0;               7;       16586;S.C.                ;S.C.                ;           0;           0;          2;Terminales                                        ;OWN F1021                                         
2015-11-24;         48;OWN                                               ;Own                   ;               10;         168;                 0;             168;         178;112,0               ;118,7               ;           2;           3;          2;Terminales                                        ;OWN F1030                                         
2015-11-24;         48;OWN                                               ;Own                   ;               14;           5;                 0;               5;          19;S.C.                ;S.C.                ;           0;           0;          2;Terminales                                        ;OWN F2020                                         
2015-11-24;         48;OWN                                               ;Own                   ;            14138;        3934;                70;            4004;       18142;90,0                ;407,7               ;          30;          89;          2;Terminales                                        ;OWN Fun                                           
2015-11-24;         48;OWN                                               ;Own                   ;            11493;        3153;                72;            3225;       14718;66,5                ;303,5               ;          37;          97;          2;Terminales                                        ;OWN S3010                                         
2015-11-24;         48;OWN                                               ;Own                   ;              198;        2457;                96;            2553;        2751;13,6                ;14,6                ;         220;         376;          2;Terminales                                        ;OWN S3015                                         
2015-11-24;         48;OWN                                               ;Own                   ;              202;         923;                15;             938;        1140;234,5               ;285,0               ;           4;           8;          2;Terminales                                        ;OWN S3030                                         
2015-11-24;         48;OWN                                               ;Own                   ;              289;          44;                 1;              45;         334;90,0                ;668,0               ;           1;           1;          2;Terminales                                        ;OWN S4010                                         
2015-11-24;         48;OWN                                               ;Own                   ;              101;        1044;                51;            1095;        1196;365,0               ;398,7               ;           2;           6;          2;Terminales                                        ;OWN S4025                                         
2015-11-24;         48;OWN                                               ;Own                   ;             8013;          40;                15;              55;        8068;110,0               ;16136,0             ;           1;           1;          2;Terminales                                        ;OWN S4035                                         
2015-11-24;         48;OWN                                               ;Own                   ;             8270;           0;                 0;               0;        8270;S.C.                ;S.C.                ;           0;           0;          2;Terminales                                        ;OWN S4035 4G                                      
2015-11-24;         48;OWN                                               ;Own                   ;              108;          22;                 0;              22;         130;S.C.                ;S.C.                ;           0;           0;          2;Terminales                                        ;OWN S4040                                         
2015-11-24;         48;OWN                                               ;Own                   ;               41;           6;                 2;               8;          49;S.C.                ;S.C.                ;           0;           0;          2;Terminales                                        ;OWN S5010                                         
2015-11-24;         48;OWN                                               ;Own                   ;              105;        2310;                28;            2338;        2443;26,0                ;27,1                ;          65;         180;          2;Terminales                                        ;OWN S5030                                         
2015-11-24;         48;OWN                                               ;Own                   ;             3214;           0;                 0;               0;        3214;S.C.                ;S.C.                ;           0;           0;          2;Terminales                                        ;OWN Selfie                                        
2015-11-24;         48;OWN                                               ;Own                   ;              120;           0;                 0;               0;         120;S.C.                ;S.C.                ;           0;           0;          2;Terminales                                        ;OWN Style                                         
2015-11-25;         48;OWN                                               ;Own                   ;            15903;           0;                 0;               0;       15903;S.C.                ;S.C.                ;           0;           0;          3;Terminales                                        ;OWN F1010                                         
2015-11-25;         48;OWN                                               ;Own                   ;                1;          34;                 0;              34;          35;S.C.                ;S.C.                ;           0;           0;          3;Terminales                                        ;OWN F1020                                         
2015-11-25;         48;OWN                                               ;Own                   ;            16024;           7;                 0;               7;       16031;S.C.                ;S.C.                ;           0;           0;          3;Terminales                                        ;OWN F1021                                         
2015-11-25;         48;OWN                                               ;Own                   ;               10;         168;                 2;             170;         180;170,0               ;180,0               ;           0;           3;          3;Terminales                                        ;OWN F1030                                         
2015-11-25;         48;OWN                                               ;Own                   ;               14;           5;                 0;               5;          19;S.C.                ;S.C.                ;           0;           0;          3;Terminales                                        ;OWN F2020                                         
2015-11-25;         48;OWN                                               ;Own                   ;            14085;        3879;               103;            3982;       18067;75,6                ;343,0               ;          69;         158;          3;Terminales                                        ;OWN Fun                                           
2015-11-25;         48;OWN                                               ;Own                   ;            10892;        3625;               144;            3769;       14661;74,9                ;291,3               ;          54;         151;          3;Terminales                                        ;OWN S3010                                         
2015-11-25;         48;OWN                                               ;Own                   ;              194;        2189;               118;            2307;        2501;11,3                ;12,2                ;         239;         615;          3;Terminales                                        ;OWN S3015                                         
2015-11-25;         48;OWN                                               ;Own                   ;              202;         922;                12;             934;        1136;200,1               ;243,4               ;           6;          14;          3;Terminales                                        ;OWN S3030                                         
2015-11-25;         48;OWN                                               ;Own                   ;              289;          45;                 0;              45;         334;S.C.                ;S.C.                ;          -1;           0;          3;Terminales                                        ;OWN S4010                                         
2015-11-25;         48;OWN                                               ;Own                   ;              101;        1060;                 5;            1065;        1166;290,5               ;318,0               ;           5;          11;          3;Terminales                                        ;OWN S4025                                         
2015-11-25;         48;OWN                                               ;Own                   ;             7953;          51;                64;             115;        8068;345,0               ;24204,0             ;           0;           1;          3;Terminales                                        ;OWN S4035                                         
2015-11-25;         48;OWN                                               ;Own                   ;             8467;           0;                 0;               0;        8467;S.C.                ;S.C.                ;           0;           0;          3;Terminales                                        ;OWN S4035 4G                                      
2015-11-25;         48;OWN                                               ;Own                   ;              108;          25;                 0;              25;         133;S.C.                ;S.C.                ;           0;           0;          3;Terminales                                        ;OWN S4040                                         
2015-11-25;         48;OWN                                               ;Own                   ;               41;           8;                 0;               8;          49;S.C.                ;S.C.                ;           0;           0;          3;Terminales                                        ;OWN S5010                                         
2015-11-25;         48;OWN                                               ;Own                   ;              104;        2243;                40;            2283;        2387;29,4                ;30,7                ;          53;         233;          3;Terminales                                        ;OWN S5030                                         
2015-11-25;         48;OWN                                               ;Own                   ;                4;           0;                 0;               0;           4;0,0                 ;6,0                 ;           2;           2;          3;Terminales                                        ;OWN Selfie                                        
2015-11-26;         48;OWN                                               ;Own                   ;            15903;           0;                 0;               0;       15903;S.C.                ;S.C.                ;           0;           0;          4;Terminales                                        ;OWN F1010                                         
2015-11-26;         48;OWN                                               ;Own                   ;                1;          32;                 0;              32;          33;S.C.                ;S.C.                ;           0;           0;          4;Terminales                                        ;OWN F1020                                         
2015-11-26;         48;OWN                                               ;Own                   ;            16024;           7;                 0;               7;       16031;S.C.                ;S.C.                ;           0;           0;          4;Terminales                                        ;OWN F1021                                         
2015-11-26;         48;OWN                                               ;Own                   ;               10;         168;                 2;             170;         180;226,7               ;240,0               ;           0;           3;          4;Terminales                                        ;OWN F1030                                         
2015-11-26;         48;OWN                                               ;Own                   ;               14;           5;                 0;               5;          19;S.C.                ;S.C.                ;           0;           0;          4;Terminales                                        ;OWN F2020                                         
2015-11-26;         48;OWN                                               ;Own                   ;            14052;        3843;                97;            3940;       17992;68,5                ;312,9               ;          72;         230;          4;Terminales                                        ;OWN Fun                                           
2015-11-26;         48;OWN                                               ;Own                   ;            10853;        3616;               118;            3734;       14587;71,5                ;279,2               ;          58;         209;          4;Terminales                                        ;OWN S3010                                         
2015-11-26;         48;OWN                                               ;Own                   ;              194;        2081;                95;            2176;        2370;11,8                ;12,8                ;         124;         739;          4;Terminales                                        ;OWN S3015                                         
2015-11-26;         48;OWN                                               ;Own                   ;              202;         909;                12;             921;        1123;136,4               ;166,4               ;          13;          27;          4;Terminales                                        ;OWN S3030                                         
2015-11-26;         48;OWN                                               ;Own                   ;              289;          45;                 0;              45;         334;S.C.                ;S.C.                ;           0;           0;          4;Terminales                                        ;OWN S4010                                         
2015-11-26;         48;OWN                                               ;Own                   ;              101;        1045;                 4;            1049;        1150;167,8               ;184,0               ;          14;          25;          4;Terminales                                        ;OWN S4025                                         
2015-11-26;         48;OWN                                               ;Own                   ;             8216;          65;                50;             115;        8331;460,0               ;33324,0             ;           0;           1;          4;Terminales                                        ;OWN S4035                                         
2015-11-26;         48;OWN                                               ;Own                   ;             7862;           0;               400;             400;        8262;S.C.                ;S.C.                ;           0;           0;          4;Terminales                                        ;OWN S4035 4G                                      
2015-11-26;         48;OWN                                               ;Own                   ;              108;          24;                 0;              24;         132;96,0                ;528,0               ;           1;           1;          4;Terminales                                        ;OWN S4040                                         
2015-11-26;         48;OWN                                               ;Own                   ;               41;           8;                 0;               8;          49;S.C.                ;S.C.                ;           0;           0;          4;Terminales                                        ;OWN S5010                                         
2015-11-26;         48;OWN                                               ;Own                   ;              104;        2140;                36;            2176;        2280;29,6                ;31,0                ;          61;         294;          4;Terminales                                        ;OWN S5030                                         
2015-11-26;         48;OWN                                               ;Own                   ;             4253;           0;                 0;               0;        4253;0,0                 ;5670,7              ;           1;           3;          4;Terminales                                        ;OWN Selfie                                        
2015-11-26;         48;OWN                                               ;Own                   ;             2666;           0;                 0;               0;        2666;S.C.                ;S.C.                ;           0;           0;          4;Terminales                                        ;OWN Style                                         
2015-11-27;         48;OWN                                               ;Own                   ;                0;           0;                 0;               0;           0;0,0                 ;0,0                 ;           0;           3;          5;Terminales                                        ;OWN F1030                                         
2015-11-27;         48;OWN                                               ;Own                   ;                0;           0;                 0;               0;           0;0,0                 ;0,0                 ;          73;         303;          5;Terminales                                        ;OWN Fun                                           
2015-11-27;         48;OWN                                               ;Own                   ;                0;           0;                 0;               0;           0;0,0                 ;0,0                 ;         131;         340;          5;Terminales                                        ;OWN S3010                                         
2015-11-27;         48;OWN                                               ;Own                   ;                0;           0;                 0;               0;           0;0,0                 ;0,0                 ;         200;         939;          5;Terminales                                        ;OWN S3015                                         
2015-11-27;         48;OWN                                               ;Own                   ;                0;           0;                 0;               0;           0;0,0                 ;0,0                 ;          22;          49;          5;Terminales                                        ;OWN S3030                                         
2015-11-27;         48;OWN                                               ;Own                   ;                0;           0;                 0;               0;           0;S.C.                ;S.C.                ;           0;           0;          5;Terminales                                        ;OWN S4010                                         
2015-11-27;         48;OWN                                               ;Own                   ;                0;           0;                 0;               0;           0;0,0                 ;0,0                 ;          42;          67;          5;Terminales                                        ;OWN S4025                                         
2015-11-27;         48;OWN                                               ;Own                   ;                0;           0;                 0;               0;           0;0,0                 ;0,0                 ;           1;           2;          5;Terminales                                        ;OWN S4035                                         
2015-11-27;         48;OWN                                               ;Own                   ;                0;           0;                 0;               0;           0;0,0                 ;0,0                 ;           0;           1;          5;Terminales                                        ;OWN S4040                                         
2015-11-27;         48;OWN                                               ;Own                   ;                0;           0;                 0;               0;           0;0,0                 ;0,0                 ;          60;         354;          5;Terminales                                        ;OWN S5030                                         
2015-11-27;         48;OWN                                               ;Own                   ;                0;           0;                 0;               0;           0;0,0                 ;0,0                 ;           0;           3;          5;Terminales                                        ;OWN Selfie                                        
2015-11-28;         48;OWN                                               ;Own                   ;                0;           0;                 0;               0;           0;0,0                 ;0,0                 ;           0;           3;          6;Terminales                                        ;OWN F1030                                         
2015-11-28;         48;OWN                                               ;Own                   ;                0;           0;                 0;               0;           0;0,0                 ;0,0                 ;          18;         321;          6;Terminales                                        ;OWN Fun                                           
2015-11-28;         48;OWN                                               ;Own                   ;                0;           0;                 0;               0;           0;0,0                 ;0,0                 ;          17;         357;          6;Terminales                                        ;OWN S3010                                         
2015-11-28;         48;OWN                                               ;Own                   ;                0;           0;                 0;               0;           0;0,0                 ;0,0                 ;          54;         993;          6;Terminales                                        ;OWN S3015                                         
2015-11-28;         48;OWN                                               ;Own                   ;                0;           0;                 0;               0;           0;0,0                 ;0,0                 ;           3;          52;          6;Terminales                                        ;OWN S3030                                         
2015-11-28;         48;OWN                                               ;Own                   ;                0;           0;                 0;               0;           0;S.C.                ;S.C.                ;           0;           0;          6;Terminales                                        ;OWN S4010                                         
2015-11-28;         48;OWN                                               ;Own                   ;                0;           0;                 0;               0;           0;0,0                 ;0,0                 ;           2;          69;          6;Terminales                                        ;OWN S4025                                         
2015-11-28;         48;OWN                                               ;Own                   ;                0;           0;                 0;               0;           0;0,0                 ;0,0                 ;           1;           3;          6;Terminales                                        ;OWN S4035                                         
2015-11-28;         48;OWN                                               ;Own                   ;                0;           0;                 0;               0;           0;0,0                 ;0,0                 ;           0;           1;          6;Terminales                                        ;OWN S4040                                         
2015-11-28;         48;OWN                                               ;Own                   ;                0;           0;                 0;               0;           0;0,0                 ;0,0                 ;          17;         371;          6;Terminales                                        ;OWN S5030                                         
2015-11-28;         48;OWN                                               ;Own                   ;                0;           0;                 0;               0;           0;0,0                 ;0,0                 ;           0;           3;          6;Terminales                                        ;OWN Selfie                                        
2015-11-29;         48;OWN                                               ;Own                   ;            14783;           0;                 0;               0;       14783;S.C.                ;S.C.                ;           0;           0;          7;Terminales                                        ;OWN F1010                                         
2015-11-29;         48;OWN                                               ;Own                   ;                1;          31;                 0;              31;          32;S.C.                ;S.C.                ;           0;           0;          7;Terminales                                        ;OWN F1020                                         
2015-11-29;         48;OWN                                               ;Own                   ;            13669;           7;                 0;               7;       13676;S.C.                ;S.C.                ;           0;           0;          7;Terminales                                        ;OWN F1021                                         
2015-11-29;         48;OWN                                               ;Own                   ;               10;         169;                 0;             169;         179;394,3               ;417,7               ;           0;           3;          7;Terminales                                        ;OWN F1030                                         
2015-11-29;         48;OWN                                               ;Own                   ;               14;           5;                 0;               5;          19;S.C.                ;S.C.                ;           0;           0;          7;Terminales                                        ;OWN F2020                                         
2015-11-29;         48;OWN                                               ;Own                   ;            12770;        3780;               138;            3918;       16688;81,6                ;347,7               ;          15;         336;          7;Terminales                                        ;OWN Fun                                           
2015-11-29;         48;OWN                                               ;Own                   ;             9975;        3504;               177;            3681;       13656;71,6                ;265,5               ;           3;         360;          7;Terminales                                        ;OWN S3010                                         
2015-11-29;         48;OWN                                               ;Own                   ;              205;        1820;                99;            1919;        2124;13,5                ;14,9                ;           5;         998;          7;Terminales                                        ;OWN S3015                                         
2015-11-29;         48;OWN                                               ;Own                   ;              207;         885;                 6;             891;        1098;119,9               ;147,8               ;           0;          52;          7;Terminales                                        ;OWN S3030                                         
2015-11-29;         48;OWN                                               ;Own                   ;              289;          45;                 0;              45;         334;S.C.                ;S.C.                ;           0;           0;          7;Terminales                                        ;OWN S4010                                         
2015-11-29;         48;OWN                                               ;Own                   ;              104;         994;                 4;             998;        1102;98,4                ;108,6               ;           2;          71;          7;Terminales                                        ;OWN S4025                                         
2015-11-29;         48;OWN                                               ;Own                   ;            11272;          93;                20;             113;       11385;263,7               ;26565,0             ;           0;           3;          7;Terminales                                        ;OWN S4035                                         
2015-11-29;         48;OWN                                               ;Own                   ;             7392;           0;               868;             868;        8260;S.C.                ;S.C.                ;           0;           0;          7;Terminales                                        ;OWN S4035 4G                                      
2015-11-29;         48;OWN                                               ;Own                   ;              108;          24;                 0;              24;         132;168,0               ;924,0               ;           0;           1;          7;Terminales                                        ;OWN S4040                                         
2015-11-29;         48;OWN                                               ;Own                   ;               41;           8;                 0;               8;          49;S.C.                ;S.C.                ;           0;           0;          7;Terminales                                        ;OWN S5010                                         
2015-11-29;         48;OWN                                               ;Own                   ;              125;        2059;                29;            2088;        2213;38,5                ;40,8                ;           9;         380;          7;Terminales                                        ;OWN S5030                                         
2015-11-29;         48;OWN                                               ;Own                   ;                4;           0;                 0;               0;           4;0,0                 ;7,0                 ;           1;           4;          7;Terminales                                        ;OWN Selfie                                        
2015-11-29;         48;OWN                                               ;Own                   ;              379;           0;                 0;               0;         379;S.C.                ;S.C.                ;           0;           0;          7;Terminales                                        ;OWN Style                                         
2015-11-30;         49;OWN                                               ;Own                   ;            13617;           0;                 0;               0;       13617;S.C.                ;S.C.                ;           0;           0;          1;Terminales                                        ;OWN F1010                                         
2015-11-30;         49;OWN                                               ;Own                   ;                1;          31;                 0;              31;          32;S.C.                ;S.C.                ;           0;           0;          1;Terminales                                        ;OWN F1020                                         
2015-11-30;         49;OWN                                               ;Own                   ;            10534;           7;                 0;               7;       10541;S.C.                ;S.C.                ;           0;           0;          1;Terminales                                        ;OWN F1021                                         
2015-11-30;         49;OWN                                               ;Own                   ;               10;         169;                 0;             169;         179;S.C.                ;S.C.                ;           0;           0;          1;Terminales                                        ;OWN F1030                                         
2015-11-30;         49;OWN                                               ;Own                   ;               14;           5;                 0;               5;          19;S.C.                ;S.C.                ;           0;           0;          1;Terminales                                        ;OWN F2020                                         
2015-11-30;         49;OWN                                               ;Own                   ;            11392;        3761;               141;            3902;       15294;52,7                ;206,7               ;          74;          74;          1;Terminales                                        ;OWN Fun                                           
2015-11-30;         49;OWN                                               ;Own                   ;             9901;        3446;               203;            3649;       13550;36,5                ;135,5               ;         100;         100;          1;Terminales                                        ;OWN S3010                                         
2015-11-30;         49;OWN                                               ;Own                   ;              206;        1645;                99;            1744;        1950;9,9                 ;11,1                ;         176;         176;          1;Terminales                                        ;OWN S3015                                         
2015-11-30;         49;OWN                                               ;Own                   ;              207;         880;                 6;             886;        1093;221,5               ;273,3               ;           4;           4;          1;Terminales                                        ;OWN S3030                                         
2015-11-30;         49;OWN                                               ;Own                   ;              289;          42;                 0;              42;         331;21,0                ;165,5               ;           2;           2;          1;Terminales                                        ;OWN S4010                                         
2015-11-30;         49;OWN                                               ;Own                   ;              106;         991;                 3;             994;        1100;248,5               ;275,0               ;           4;           4;          1;Terminales                                        ;OWN S4025                                         
2015-11-30;         49;OWN                                               ;Own                   ;            11272;          93;                20;             113;       11385;56,5                ;5692,5              ;           2;           2;          1;Terminales                                        ;OWN S4035                                         
2015-11-30;         49;OWN                                               ;Own                   ;             8393;           0;              1117;            1117;        9510;S.C.                ;S.C.                ;           0;           0;          1;Terminales                                        ;OWN S4035 4G                                      
2015-11-30;         49;OWN                                               ;Own                   ;              108;          24;                 0;              24;         132;S.C.                ;S.C.                ;           0;           0;          1;Terminales                                        ;OWN S4040                                         
2015-11-30;         49;OWN                                               ;Own                   ;               41;           8;                 0;               8;          49;S.C.                ;S.C.                ;           0;           0;          1;Terminales                                        ;OWN S5010                                         
2015-11-30;         49;OWN                                               ;Own                   ;              125;        2007;                26;            2033;        2158;41,5                ;44,0                ;          49;          49;          1;Terminales                                        ;OWN S5030                                         
2015-11-30;         49;OWN                                               ;Own                   ;                4;           0;                 0;               0;           4;S.C.                ;S.C.                ;           0;           0;          1;Terminales                                        ;OWN Selfie                                        
2015-11-30;         49;OWN                                               ;Own                   ;             2669;           0;                 0;               0;        2669;S.C.                ;S.C.                ;           0;           0;          1;Terminales                                        ;OWN Style                                         
2015-11-16;         47;Samsung                                           ;iPhone y Premium      ;                4;          45;                 0;              45;          49;S.C.                ;S.C.                ;           0;           0;          1;Terminales                                        ;SAM GLXY Alpha                                    
2015-11-16;         47;Samsung                                           ;iPhone y Premium      ;               30;          47;                 2;              49;          79;S.C.                ;S.C.                ;           0;           0;          1;Terminales                                        ;SAM GLXY S4                                       
2015-11-16;         47;Samsung                                           ;iPhone y Premium      ;               59;         103;                 9;             112;         171;56,0                ;85,5                ;           2;           2;          1;Terminales                                        ;SAM GLXY S5                                       
2015-11-16;         47;Samsung                                           ;iPhone y Premium      ;              603;        1806;                76;            1882;        2485;19,8                ;26,2                ;          95;          95;          1;Terminales                                        ;SAM GLXY S6                                       
2015-11-16;         47;Samsung                                           ;iPhone y Premium      ;              639;        1297;               104;            1401;        2040;30,5                ;44,3                ;          46;          46;          1;Terminales                                        ;SAM GLXY S6 EDGE                                  
2015-11-16;         47;Samsung                                           ;iPhone y Premium      ;              747;         180;                53;             233;         980;11,7                ;49,0                ;          20;          20;          1;Terminales                                        ;SAM GLXY S6 EDGE PLUS                             
2015-11-16;         47;Samsung                                           ;iPhone y Premium      ;                0;          10;                 0;              10;          10;S.C.                ;S.C.                ;           0;           0;          1;Terminales                                        ;SAM I9100                                         
2015-11-16;         47;Samsung                                           ;iPhone y Premium      ;                1;          20;                 2;              22;          23;S.C.                ;S.C.                ;           0;           0;          1;Terminales                                        ;SAM I9195                                         
2015-11-16;         47;Samsung                                           ;iPhone y Premium      ;                0;           2;                 0;               2;           2;S.C.                ;S.C.                ;           0;           0;          1;Terminales                                        ;SAM I9250                                         
2015-11-16;         47;Samsung                                           ;iPhone y Premium      ;                4;          20;                 0;              20;          24;10,0                ;12,0                ;           2;           2;          1;Terminales                                        ;SAM Note 3 Neo                                    
2015-11-16;         47;Samsung                                           ;iPhone y Premium      ;              241;         187;                 7;             194;         435;97,0                ;217,5               ;           2;           2;          1;Terminales                                        ;SAM Note IV                                       
2015-11-16;         47;Samsung                                           ;iPhone y Premium      ;                0;           4;                 0;               4;           4;S.C.                ;S.C.                ;           0;           0;          1;Terminales                                        ;SAM Note N7000                                    
2015-11-16;         47;Samsung                                           ;iPhone y Premium      ;                0;           2;                 2;               4;           4;S.C.                ;S.C.                ;           0;           0;          1;Terminales                                        ;SAM Note N9005                                    
2015-11-16;         47;Samsung                                           ;Smarthphones y Masivos;                1;           0;                 0;               0;           1;S.C.                ;S.C.                ;           0;           0;          1;Terminales                                        ;SAM C276                                          
2015-11-16;         47;Samsung                                           ;Smarthphones y Masivos;                1;           5;                 0;               5;           6;S.C.                ;S.C.                ;           0;           0;          1;Terminales                                        ;SAM C3300                                         
2015-11-16;         47;Samsung                                           ;Smarthphones y Masivos;                2;           3;                 0;               3;           5;S.C.                ;S.C.                ;           0;           0;          1;Terminales                                        ;SAM C3310                                         
2015-11-16;         47;Samsung                                           ;Smarthphones y Masivos;                1;           0;                 0;               0;           1;S.C.                ;S.C.                ;           0;           0;          1;Terminales                                        ;SAM C3510                                         
2015-11-16;         47;Samsung                                           ;Smarthphones y Masivos;                0;           3;                 0;               3;           3;S.C.                ;S.C.                ;           0;           0;          1;Terminales                                        ;SAM C3520                                         
2015-11-16;         47;Samsung                                           ;Smarthphones y Masivos;               27;           0;                 0;               0;          27;S.C.                ;S.C.                ;           0;           0;          1;Terminales                                        ;SAM E1205                                         
2015-11-16;         47;Samsung                                           ;Smarthphones y Masivos;                2;           0;                 0;               0;           2;S.C.                ;S.C.                ;           0;           0;          1;Terminales                                        ;SAM E2121                                         
2015-11-16;         47;Samsung                                           ;Smarthphones y Masivos;               16;           0;                 0;               0;          16;S.C.                ;S.C.                ;           0;           0;          1;Terminales                                        ;SAM E2230                                         
2015-11-16;         47;Samsung                                           ;Smarthphones y Masivos;                2;           0;                 0;               0;           2;S.C.                ;S.C.                ;           0;           0;          1;Terminales                                        ;SAM E3210                                         
2015-11-16;         47;Samsung                                           ;Smarthphones y Masivos;                2;           0;                 0;               0;           2;S.C.                ;S.C.                ;           0;           0;          1;Terminales                                        ;SAM E3300                                         
2015-11-16;         47;Samsung                                           ;Smarthphones y Masivos;              108;           0;                 0;               0;         108;S.C.                ;S.C.                ;           0;           0;          1;Terminales                                        ;SAM Gear S R750                                   
2015-11-16;         47;Samsung                                           ;Smarthphones y Masivos;               98;         184;                 1;             185;         283;S.C.                ;S.C.                ;           0;           0;          1;Terminales                                        ;SAM GLXY A5                                       
2015-11-16;         47;Samsung                                           ;Smarthphones y Masivos;             3479;           0;                 0;               0;        3479;S.C.                ;S.C.                ;           0;           0;          1;Terminales                                        ;SAM GLXY Ace 4                                    
2015-11-16;         47;Samsung                                           ;Smarthphones y Masivos;              352;         501;                 1;             502;         854;83,7                ;142,3               ;           6;           6;          1;Terminales                                        ;SAM GLXY Ace 4 Lite                               
2015-11-16;         47;Samsung                                           ;Smarthphones y Masivos;             7735;        2442;              1114;            3556;       11291;39,5                ;125,5               ;          90;          90;          1;Terminales                                        ;SAM GLXY Ace 4 Neo                                
2015-11-16;         47;Samsung                                           ;Smarthphones y Masivos;              257;         102;                 2;             104;         361;S.C.                ;S.C.                ;           0;           0;          1;Terminales                                        ;SAM GLXY Core 2                                   
2015-11-16;         47;Samsung                                           ;Smarthphones y Masivos;              213;        1850;                 1;            1851;        2064;462,8               ;516,0               ;           4;           4;          1;Terminales                                        ;SAM GLXY Core Prime                               
2015-11-16;         47;Samsung                                           ;Smarthphones y Masivos;              549;        1488;               133;            1621;        2170;270,2               ;361,7               ;           6;           6;          1;Terminales                                        ;SAM GLXY Grand Prime LTE                          
2015-11-16;         47;Samsung                                           ;Smarthphones y Masivos;             5864;        6135;              1535;            7670;       13534;14,0                ;24,8                ;         546;         546;          1;Terminales                                        ;SAM GLXY J1                                       
2015-11-16;         47;Samsung                                           ;Smarthphones y Masivos;            14767;        6863;              3573;           10436;       25203;9,7                 ;23,4                ;        1076;        1076;          1;Terminales                                        ;SAM GLXY J5                                       
2015-11-16;         47;Samsung                                           ;Smarthphones y Masivos;             3972;         706;               590;            1296;        5268;S.C.                ;S.C.                ;           0;           0;          1;Terminales                                        ;SAM GLXY J7                                       
2015-11-16;         47;Samsung                                           ;Smarthphones y Masivos;                0;           4;                 1;               5;           5;S.C.                ;S.C.                ;           0;           0;          1;Terminales                                        ;SAM i8190                                         
2015-11-16;         47;Samsung                                           ;Smarthphones y Masivos;                3;           0;                 0;               0;           3;S.C.                ;S.C.                ;           0;           0;          1;Terminales                                        ;SAM I8260                                         
2015-11-16;         47;Samsung                                           ;Smarthphones y Masivos;               93;         125;                 6;             131;         224;131,0               ;224,0               ;           1;           1;          1;Terminales                                        ;SAM I8550                                         
2015-11-16;         47;Samsung                                           ;Smarthphones y Masivos;                1;           0;                 0;               0;           1;S.C.                ;S.C.                ;           0;           0;          1;Terminales                                        ;SAM i9070                                         
2015-11-16;         47;Samsung                                           ;Smarthphones y Masivos;              248;          21;                 1;              22;         270;S.C.                ;S.C.                ;           0;           0;          1;Terminales                                        ;SAM I9080                                         
2015-11-16;         47;Samsung                                           ;Smarthphones y Masivos;               25;          19;                 2;              21;          46;S.C.                ;S.C.                ;           0;           0;          1;Terminales                                        ;SAM I9300                                         
2015-11-16;         47;Samsung                                           ;Smarthphones y Masivos;                1;           3;                 0;               3;           4;S.C.                ;S.C.                ;           0;           0;          1;Terminales                                        ;SAM M3710                                         
2015-11-16;         47;Samsung                                           ;Smarthphones y Masivos;                0;           2;                 0;               2;           2;S.C.                ;S.C.                ;           0;           0;          1;Terminales                                        ;SAM S3770                                         
2015-11-16;         47;Samsung                                           ;Smarthphones y Masivos;                1;           0;                 0;               0;           1;S.C.                ;S.C.                ;           0;           0;          1;Terminales                                        ;SAM S5230                                         
2015-11-16;         47;Samsung                                           ;Smarthphones y Masivos;              256;         348;                 2;             350;         606;70,0                ;121,2               ;           5;           5;          1;Terminales                                        ;SAM S5310                                         
2015-11-16;         47;Samsung                                           ;Smarthphones y Masivos;                0;          14;                 1;              15;          15;S.C.                ;S.C.                ;           0;           0;          1;Terminales                                        ;SAM S5360                                         
2015-11-16;         47;Samsung                                           ;Smarthphones y Masivos;                7;           0;                 0;               0;           7;S.C.                ;S.C.                ;           0;           0;          1;Terminales                                        ;SAM S5560                                         
2015-11-16;         47;Samsung                                           ;Smarthphones y Masivos;                0;           1;                 0;               1;           1;S.C.                ;S.C.                ;           0;           0;          1;Terminales                                        ;SAM S5570                                         
2015-11-16;         47;Samsung                                           ;Smarthphones y Masivos;                1;           3;                 1;               4;           5;S.C.                ;S.C.                ;           0;           0;          1;Terminales                                        ;SAM S5830                                         
2015-11-16;         47;Samsung                                           ;Smarthphones y Masivos;               10;           0;                 0;               0;          10;S.C.                ;S.C.                ;           0;           0;          1;Terminales                                        ;SAM S6010                                         
2015-11-16;         47;Samsung                                           ;Smarthphones y Masivos;               35;          34;                 1;              35;          70;S.C.                ;S.C.                ;           0;           0;          1;Terminales                                        ;SAM S6310                                         
2015-11-16;         47;Samsung                                           ;Smarthphones y Masivos;                1;           0;                 0;               0;           1;S.C.                ;S.C.                ;           0;           0;          1;Terminales                                        ;SAM S6500                                         
2015-11-16;         47;Samsung                                           ;Smarthphones y Masivos;               56;          10;                 0;              10;          66;S.C.                ;S.C.                ;           0;           0;          1;Terminales                                        ;SAM S6810E                                        
2015-11-16;         47;Samsung                                           ;Smarthphones y Masivos;                0;          13;                 1;              14;          14;S.C.                ;S.C.                ;           0;           0;          1;Terminales                                        ;SAM S7500                                         
2015-11-16;         47;Samsung                                           ;Smarthphones y Masivos;                8;          15;                 2;              17;          25;S.C.                ;S.C.                ;           0;           0;          1;Terminales                                        ;SAM S7560                                         
2015-11-16;         47;Samsung                                           ;Smarthphones y Masivos;              180;          28;                 1;              29;         209;S.C.                ;S.C.                ;           0;           0;          1;Terminales                                        ;SAM S7580                                         
2015-11-17;         47;Samsung                                           ;iPhone y Premium      ;                4;          45;                 0;              45;          49;S.C.                ;S.C.                ;           0;           0;          2;Terminales                                        ;SAM GLXY Alpha                                    
2015-11-17;         47;Samsung                                           ;iPhone y Premium      ;               30;          44;                 2;              46;          76;30,7                ;50,7                ;           3;           3;          2;Terminales                                        ;SAM GLXY S4                                       
2015-11-17;         47;Samsung                                           ;iPhone y Premium      ;               59;          99;                 9;             108;         167;108,0               ;167,0               ;           0;           2;          2;Terminales                                        ;SAM GLXY S5                                       
2015-11-17;         47;Samsung                                           ;iPhone y Premium      ;              523;        1728;               256;            1984;        2507;22,8                ;28,8                ;          79;         174;          2;Terminales                                        ;SAM GLXY S6                                       
2015-11-17;         47;Samsung                                           ;iPhone y Premium      ;              678;        1256;               133;            1389;        2067;28,1                ;41,8                ;          53;          99;          2;Terminales                                        ;SAM GLXY S6 EDGE                                  
2015-11-17;         47;Samsung                                           ;iPhone y Premium      ;              403;         165;               411;             576;         979;28,1                ;47,8                ;          21;          41;          2;Terminales                                        ;SAM GLXY S6 EDGE PLUS                             
2015-11-17;         47;Samsung                                           ;iPhone y Premium      ;                0;          10;                 0;              10;          10;S.C.                ;S.C.                ;           0;           0;          2;Terminales                                        ;SAM I9100                                         
2015-11-17;         47;Samsung                                           ;iPhone y Premium      ;                1;          20;                 2;              22;          23;S.C.                ;S.C.                ;           0;           0;          2;Terminales                                        ;SAM I9195                                         
2015-11-17;         47;Samsung                                           ;iPhone y Premium      ;                0;           2;                 0;               2;           2;S.C.                ;S.C.                ;           0;           0;          2;Terminales                                        ;SAM I9250                                         
2015-11-17;         47;Samsung                                           ;iPhone y Premium      ;                4;          19;                 0;              19;          23;12,7                ;15,3                ;           1;           3;          2;Terminales                                        ;SAM Note 3 Neo                                    
2015-11-17;         47;Samsung                                           ;iPhone y Premium      ;              220;         203;                 3;             206;         426;82,4                ;170,4               ;           3;           5;          2;Terminales                                        ;SAM Note IV                                       
2015-11-17;         47;Samsung                                           ;iPhone y Premium      ;                0;           4;                 0;               4;           4;S.C.                ;S.C.                ;           0;           0;          2;Terminales                                        ;SAM Note N7000                                    
2015-11-17;         47;Samsung                                           ;iPhone y Premium      ;                0;           2;                 2;               4;           4;S.C.                ;S.C.                ;           0;           0;          2;Terminales                                        ;SAM Note N9005                                    
2015-11-17;         47;Samsung                                           ;Smarthphones y Masivos;                1;           0;                 0;               0;           1;S.C.                ;S.C.                ;           0;           0;          2;Terminales                                        ;SAM C276                                          
2015-11-17;         47;Samsung                                           ;Smarthphones y Masivos;                1;           5;                 0;               5;           6;S.C.                ;S.C.                ;           0;           0;          2;Terminales                                        ;SAM C3300                                         
2015-11-17;         47;Samsung                                           ;Smarthphones y Masivos;                2;           3;                 0;               3;           5;S.C.                ;S.C.                ;           0;           0;          2;Terminales                                        ;SAM C3310                                         
2015-11-17;         47;Samsung                                           ;Smarthphones y Masivos;                1;           0;                 0;               0;           1;S.C.                ;S.C.                ;           0;           0;          2;Terminales                                        ;SAM C3510                                         
2015-11-17;         47;Samsung                                           ;Smarthphones y Masivos;                0;           3;                 0;               3;           3;S.C.                ;S.C.                ;           0;           0;          2;Terminales                                        ;SAM C3520                                         
2015-11-17;         47;Samsung                                           ;Smarthphones y Masivos;               27;           0;                 0;               0;          27;S.C.                ;S.C.                ;           0;           0;          2;Terminales                                        ;SAM E1205                                         
2015-11-17;         47;Samsung                                           ;Smarthphones y Masivos;                2;           0;                 0;               0;           2;S.C.                ;S.C.                ;           0;           0;          2;Terminales                                        ;SAM E2121                                         
2015-11-17;         47;Samsung                                           ;Smarthphones y Masivos;               16;           0;                 0;               0;          16;S.C.                ;S.C.                ;           0;           0;          2;Terminales                                        ;SAM E2230                                         
2015-11-17;         47;Samsung                                           ;Smarthphones y Masivos;                2;           0;                 0;               0;           2;S.C.                ;S.C.                ;           0;           0;          2;Terminales                                        ;SAM E3210                                         
2015-11-17;         47;Samsung                                           ;Smarthphones y Masivos;                2;           0;                 0;               0;           2;S.C.                ;S.C.                ;           0;           0;          2;Terminales                                        ;SAM E3300                                         
2015-11-17;         47;Samsung                                           ;Smarthphones y Masivos;              108;           0;                 0;               0;         108;S.C.                ;S.C.                ;           0;           0;          2;Terminales                                        ;SAM Gear S R750                                   
2015-11-17;         47;Samsung                                           ;Smarthphones y Masivos;               98;         183;                 1;             184;         282;184,0               ;282,0               ;           2;           2;          2;Terminales                                        ;SAM GLXY A5                                       
2015-11-17;         47;Samsung                                           ;Smarthphones y Masivos;             5399;           0;                 0;               0;        5399;S.C.                ;S.C.                ;           0;           0;          2;Terminales                                        ;SAM GLXY Ace 4                                    
2015-11-17;         47;Samsung                                           ;Smarthphones y Masivos;              352;         494;                 1;             495;         847;82,5                ;141,2               ;           6;          12;          2;Terminales                                        ;SAM GLXY Ace 4 Lite                               
2015-11-17;         47;Samsung                                           ;Smarthphones y Masivos;             7610;        2365;              1115;            3480;       11090;42,4                ;135,2               ;          74;         164;          2;Terminales                                        ;SAM GLXY Ace 4 Neo                                
2015-11-17;         47;Samsung                                           ;Smarthphones y Masivos;              257;          97;                 2;              99;         356;S.C.                ;S.C.                ;           0;           0;          2;Terminales                                        ;SAM GLXY Core 2                                   
2015-11-17;         47;Samsung                                           ;Smarthphones y Masivos;              213;        1837;                 0;            1837;        2050;408,2               ;455,6               ;           5;           9;          2;Terminales                                        ;SAM GLXY Core Prime                               
2015-11-17;         47;Samsung                                           ;Smarthphones y Masivos;              549;        1448;               133;            1581;        2130;210,8               ;284,0               ;           9;          15;          2;Terminales                                        ;SAM GLXY Grand Prime LTE                          
2015-11-17;         47;Samsung                                           ;Smarthphones y Masivos;             4755;        6389;              1901;            8290;       13045;16,2                ;25,5                ;         477;        1023;          2;Terminales                                        ;SAM GLXY J1                                       
2015-11-17;         47;Samsung                                           ;Smarthphones y Masivos;            11325;        7564;              4953;           12517;       23842;11,1                ;21,2                ;        1175;        2251;          2;Terminales                                        ;SAM GLXY J5                                       
2015-11-17;         47;Samsung                                           ;Smarthphones y Masivos;             2635;         758;              1867;            2625;        5260;1750,0              ;3506,7              ;           3;           3;          2;Terminales                                        ;SAM GLXY J7                                       
2015-11-17;         47;Samsung                                           ;Smarthphones y Masivos;                0;           4;                 1;               5;           5;S.C.                ;S.C.                ;           0;           0;          2;Terminales                                        ;SAM i8190                                         
2015-11-17;         47;Samsung                                           ;Smarthphones y Masivos;                3;           0;                 0;               0;           3;S.C.                ;S.C.                ;           0;           0;          2;Terminales                                        ;SAM I8260                                         
2015-11-17;         47;Samsung                                           ;Smarthphones y Masivos;               93;         125;                 6;             131;         224;52,4                ;89,6                ;           4;           5;          2;Terminales                                        ;SAM I8550                                         
2015-11-17;         47;Samsung                                           ;Smarthphones y Masivos;                1;           0;                 0;               0;           1;S.C.                ;S.C.                ;           0;           0;          2;Terminales                                        ;SAM i9070                                         
2015-11-17;         47;Samsung                                           ;Smarthphones y Masivos;              248;          21;                 1;              22;         270;S.C.                ;S.C.                ;           0;           0;          2;Terminales                                        ;SAM I9080                                         
2015-11-17;         47;Samsung                                           ;Smarthphones y Masivos;               25;          19;                 2;              21;          46;S.C.                ;S.C.                ;           0;           0;          2;Terminales                                        ;SAM I9300                                         
2015-11-17;         47;Samsung                                           ;Smarthphones y Masivos;                1;           3;                 0;               3;           4;S.C.                ;S.C.                ;           0;           0;          2;Terminales                                        ;SAM M3710                                         
2015-11-17;         47;Samsung                                           ;Smarthphones y Masivos;                0;           2;                 0;               2;           2;S.C.                ;S.C.                ;           0;           0;          2;Terminales                                        ;SAM S3770                                         
2015-11-17;         47;Samsung                                           ;Smarthphones y Masivos;                1;           0;                 0;               0;           1;S.C.                ;S.C.                ;           0;           0;          2;Terminales                                        ;SAM S5230                                         
2015-11-17;         47;Samsung                                           ;Smarthphones y Masivos;              256;         334;                 2;             336;         592;112,0               ;197,3               ;           1;           6;          2;Terminales                                        ;SAM S5310                                         
2015-11-17;         47;Samsung                                           ;Smarthphones y Masivos;                0;          14;                 1;              15;          15;S.C.                ;S.C.                ;           0;           0;          2;Terminales                                        ;SAM S5360                                         
2015-11-17;         47;Samsung                                           ;Smarthphones y Masivos;                7;           0;                 0;               0;           7;S.C.                ;S.C.                ;           0;           0;          2;Terminales                                        ;SAM S5560                                         
2015-11-17;         47;Samsung                                           ;Smarthphones y Masivos;                0;           1;                 0;               1;           1;S.C.                ;S.C.                ;           0;           0;          2;Terminales                                        ;SAM S5570                                         
2015-11-17;         47;Samsung                                           ;Smarthphones y Masivos;                1;           3;                 1;               4;           5;S.C.                ;S.C.                ;           0;           0;          2;Terminales                                        ;SAM S5830                                         
2015-11-17;         47;Samsung                                           ;Smarthphones y Masivos;               10;           0;                 0;               0;          10;S.C.                ;S.C.                ;           0;           0;          2;Terminales                                        ;SAM S6010                                         
2015-11-17;         47;Samsung                                           ;Smarthphones y Masivos;               35;          34;                 1;              35;          70;S.C.                ;S.C.                ;           0;           0;          2;Terminales                                        ;SAM S6310                                         
2015-11-17;         47;Samsung                                           ;Smarthphones y Masivos;                1;           0;                 0;               0;           1;S.C.                ;S.C.                ;           0;           0;          2;Terminales                                        ;SAM S6500                                         
2015-11-17;         47;Samsung                                           ;Smarthphones y Masivos;               56;          10;                 0;              10;          66;S.C.                ;S.C.                ;           0;           0;          2;Terminales                                        ;SAM S6810E                                        
2015-11-17;         47;Samsung                                           ;Smarthphones y Masivos;                0;          13;                 1;              14;          14;S.C.                ;S.C.                ;           0;           0;          2;Terminales                                        ;SAM S7500                                         
2015-11-17;         47;Samsung                                           ;Smarthphones y Masivos;                8;          15;                 2;              17;          25;S.C.                ;S.C.                ;           0;           0;          2;Terminales                                        ;SAM S7560                                         
2015-11-17;         47;Samsung                                           ;Smarthphones y Masivos;              180;          28;                 1;              29;         209;S.C.                ;S.C.                ;           0;           0;          2;Terminales                                        ;SAM S7580                                         
2015-11-18;         47;Samsung                                           ;iPhone y Premium      ;               11;          45;                 0;              45;          56;S.C.                ;S.C.                ;           0;           0;          3;Terminales                                        ;SAM GLXY Alpha                                    
2015-11-18;         47;Samsung                                           ;iPhone y Premium      ;               30;          44;                 2;              46;          76;46,0                ;76,0                ;           0;           3;          3;Terminales                                        ;SAM GLXY S4                                       
2015-11-18;         47;Samsung                                           ;iPhone y Premium      ;               61;          99;                 9;             108;         169;13,0                ;20,3                ;          23;          25;          3;Terminales                                        ;SAM GLXY S5                                       
2015-11-18;         47;Samsung                                           ;iPhone y Premium      ;              441;        1640;               331;            1971;        2412;21,8                ;26,7                ;          97;         271;          3;Terminales                                        ;SAM GLXY S6                                       
2015-11-18;         47;Samsung                                           ;iPhone y Premium      ;              679;        1257;                86;            1343;        2022;28,6                ;43,0                ;          42;         141;          3;Terminales                                        ;SAM GLXY S6 EDGE                                  
2015-11-18;         47;Samsung                                           ;iPhone y Premium      ;              379;         153;               436;             589;         968;32,7                ;53,8                ;          13;          54;          3;Terminales                                        ;SAM GLXY S6 EDGE PLUS                             
2015-11-18;         47;Samsung                                           ;iPhone y Premium      ;                0;           8;                 0;               8;           8;S.C.                ;S.C.                ;           0;           0;          3;Terminales                                        ;SAM I9100                                         
2015-11-18;         47;Samsung                                           ;iPhone y Premium      ;                9;          20;                 2;              22;          31;S.C.                ;S.C.                ;           0;           0;          3;Terminales                                        ;SAM I9195                                         
2015-11-18;         47;Samsung                                           ;iPhone y Premium      ;                0;           2;                 0;               2;           2;S.C.                ;S.C.                ;           0;           0;          3;Terminales                                        ;SAM I9250                                         
2015-11-18;         47;Samsung                                           ;iPhone y Premium      ;                4;          17;                 0;              17;          21;10,2                ;12,6                ;           2;           5;          3;Terminales                                        ;SAM Note 3 Neo                                    
2015-11-18;         47;Samsung                                           ;iPhone y Premium      ;              227;         200;                 3;             203;         430;87,0                ;184,3               ;           2;           7;          3;Terminales                                        ;SAM Note IV                                       
2015-11-18;         47;Samsung                                           ;iPhone y Premium      ;                0;           2;                 0;               2;           2;S.C.                ;S.C.                ;           0;           0;          3;Terminales                                        ;SAM Note N7000                                    
2015-11-18;         47;Samsung                                           ;iPhone y Premium      ;                1;           2;                 2;               4;           5;S.C.                ;S.C.                ;           0;           0;          3;Terminales                                        ;SAM Note N9005                                    
2015-11-18;         47;Samsung                                           ;Smarthphones y Masivos;                1;           0;                 0;               0;           1;S.C.                ;S.C.                ;           0;           0;          3;Terminales                                        ;SAM C276                                          
2015-11-18;         47;Samsung                                           ;Smarthphones y Masivos;                1;           5;                 0;               5;           6;S.C.                ;S.C.                ;           0;           0;          3;Terminales                                        ;SAM C3300                                         
2015-11-18;         47;Samsung                                           ;Smarthphones y Masivos;                2;           3;                 0;               3;           5;S.C.                ;S.C.                ;           0;           0;          3;Terminales                                        ;SAM C3310                                         
2015-11-18;         47;Samsung                                           ;Smarthphones y Masivos;                1;           0;                 0;               0;           1;S.C.                ;S.C.                ;           0;           0;          3;Terminales                                        ;SAM C3510                                         
2015-11-18;         47;Samsung                                           ;Smarthphones y Masivos;                0;           3;                 0;               3;           3;S.C.                ;S.C.                ;           0;           0;          3;Terminales                                        ;SAM C3520                                         
2015-11-18;         47;Samsung                                           ;Smarthphones y Masivos;               27;           0;                 0;               0;          27;S.C.                ;S.C.                ;           0;           0;          3;Terminales                                        ;SAM E1205                                         
2015-11-18;         47;Samsung                                           ;Smarthphones y Masivos;                2;           0;                 0;               0;           2;S.C.                ;S.C.                ;           0;           0;          3;Terminales                                        ;SAM E2121                                         
2015-11-18;         47;Samsung                                           ;Smarthphones y Masivos;               16;           0;                 0;               0;          16;S.C.                ;S.C.                ;           0;           0;          3;Terminales                                        ;SAM E2230                                         
2015-11-18;         47;Samsung                                           ;Smarthphones y Masivos;                2;           0;                 0;               0;           2;S.C.                ;S.C.                ;           0;           0;          3;Terminales                                        ;SAM E3210                                         
2015-11-18;         47;Samsung                                           ;Smarthphones y Masivos;                2;           0;                 0;               0;           2;S.C.                ;S.C.                ;           0;           0;          3;Terminales                                        ;SAM E3300                                         
2015-11-18;         47;Samsung                                           ;Smarthphones y Masivos;              108;           0;                 0;               0;         108;S.C.                ;S.C.                ;           0;           0;          3;Terminales                                        ;SAM Gear S R750                                   
2015-11-18;         47;Samsung                                           ;Smarthphones y Masivos;              107;         180;                 1;             181;         288;135,8               ;216,0               ;           2;           4;          3;Terminales                                        ;SAM GLXY A5                                       
2015-11-18;         47;Samsung                                           ;Smarthphones y Masivos;             3224;           0;                 0;               0;        3224;S.C.                ;S.C.                ;           0;           0;          3;Terminales                                        ;SAM GLXY Ace 4                                    
2015-11-18;         47;Samsung                                           ;Smarthphones y Masivos;              357;         493;                 1;             494;         851;123,5               ;212,8               ;           0;          12;          3;Terminales                                        ;SAM GLXY Ace 4 Lite                               
2015-11-18;         47;Samsung                                           ;Smarthphones y Masivos;             4978;        2468;              1904;            4372;        9350;52,7                ;112,7               ;          85;         249;          3;Terminales                                        ;SAM GLXY Ace 4 Neo                                
2015-11-18;         47;Samsung                                           ;Smarthphones y Masivos;              269;          96;                 2;              98;         367;S.C.                ;S.C.                ;           0;           0;          3;Terminales                                        ;SAM GLXY Core 2                                   
2015-11-18;         47;Samsung                                           ;Smarthphones y Masivos;              245;        1827;                 0;            1827;        2072;498,3               ;565,1               ;           2;          11;          3;Terminales                                        ;SAM GLXY Core Prime                               
2015-11-18;         47;Samsung                                           ;Smarthphones y Masivos;              606;        1543;                33;            1576;        2182;295,5               ;409,1               ;           1;          16;          3;Terminales                                        ;SAM GLXY Grand Prime LTE                          
2015-11-18;         47;Samsung                                           ;Smarthphones y Masivos;             4415;        6733;              1366;            8099;       12514;15,6                ;24,2                ;         530;        1553;          3;Terminales                                        ;SAM GLXY J1                                       
2015-11-18;         47;Samsung                                           ;Smarthphones y Masivos;            13383;        7579;              4803;           12382;       25765;11,3                ;23,6                ;        1030;        3281;          3;Terminales                                        ;SAM GLXY J5                                       
2015-11-18;         47;Samsung                                           ;Smarthphones y Masivos;             2635;        1194;              1400;            2594;        5229;228,9               ;461,4               ;          31;          34;          3;Terminales                                        ;SAM GLXY J7                                       
2015-11-18;         47;Samsung                                           ;Smarthphones y Masivos;                2;           4;                 1;               5;           7;S.C.                ;S.C.                ;           0;           0;          3;Terminales                                        ;SAM i8190                                         
2015-11-18;         47;Samsung                                           ;Smarthphones y Masivos;                3;           0;                 0;               0;           3;S.C.                ;S.C.                ;           0;           0;          3;Terminales                                        ;SAM I8260                                         
2015-11-18;         47;Samsung                                           ;Smarthphones y Masivos;               95;         125;                 6;             131;         226;78,6                ;135,6               ;           0;           5;          3;Terminales                                        ;SAM I8550                                         
2015-11-18;         47;Samsung                                           ;Smarthphones y Masivos;                1;           0;                 0;               0;           1;S.C.                ;S.C.                ;           0;           0;          3;Terminales                                        ;SAM i9070                                         
2015-11-18;         47;Samsung                                           ;Smarthphones y Masivos;              249;          21;                 1;              22;         271;S.C.                ;S.C.                ;           0;           0;          3;Terminales                                        ;SAM I9080                                         
2015-11-18;         47;Samsung                                           ;Smarthphones y Masivos;               32;          17;                 2;              19;          51;S.C.                ;S.C.                ;           0;           0;          3;Terminales                                        ;SAM I9300                                         
2015-11-18;         47;Samsung                                           ;Smarthphones y Masivos;                1;           3;                 0;               3;           4;S.C.                ;S.C.                ;           0;           0;          3;Terminales                                        ;SAM M3710                                         
2015-11-18;         47;Samsung                                           ;Smarthphones y Masivos;                0;           2;                 0;               2;           2;S.C.                ;S.C.                ;           0;           0;          3;Terminales                                        ;SAM S3770                                         
2015-11-18;         47;Samsung                                           ;Smarthphones y Masivos;                1;           0;                 0;               0;           1;S.C.                ;S.C.                ;           0;           0;          3;Terminales                                        ;SAM S5230                                         
2015-11-18;         47;Samsung                                           ;Smarthphones y Masivos;              267;         334;                 2;             336;         603;201,6               ;361,8               ;          -1;           5;          3;Terminales                                        ;SAM S5310                                         
2015-11-18;         47;Samsung                                           ;Smarthphones y Masivos;                0;          14;                 1;              15;          15;S.C.                ;S.C.                ;           0;           0;          3;Terminales                                        ;SAM S5360                                         
2015-11-18;         47;Samsung                                           ;Smarthphones y Masivos;                7;           0;                 0;               0;           7;S.C.                ;S.C.                ;           0;           0;          3;Terminales                                        ;SAM S5560                                         
2015-11-18;         47;Samsung                                           ;Smarthphones y Masivos;                0;           1;                 0;               1;           1;S.C.                ;S.C.                ;           0;           0;          3;Terminales                                        ;SAM S5570                                         
2015-11-18;         47;Samsung                                           ;Smarthphones y Masivos;                1;           3;                 1;               4;           5;S.C.                ;S.C.                ;           0;           0;          3;Terminales                                        ;SAM S5830                                         
2015-11-18;         47;Samsung                                           ;Smarthphones y Masivos;               10;           0;                 0;               0;          10;S.C.                ;S.C.                ;           0;           0;          3;Terminales                                        ;SAM S6010                                         
2015-11-18;         47;Samsung                                           ;Smarthphones y Masivos;               49;          34;                 1;              35;          84;S.C.                ;S.C.                ;           0;           0;          3;Terminales                                        ;SAM S6310                                         
2015-11-18;         47;Samsung                                           ;Smarthphones y Masivos;                1;           0;                 0;               0;           1;S.C.                ;S.C.                ;           0;           0;          3;Terminales                                        ;SAM S6500                                         
2015-11-18;         47;Samsung                                           ;Smarthphones y Masivos;               71;          10;                 0;              10;          81;S.C.                ;S.C.                ;           0;           0;          3;Terminales                                        ;SAM S6810E                                        
2015-11-18;         47;Samsung                                           ;Smarthphones y Masivos;                4;          13;                 1;              14;          18;S.C.                ;S.C.                ;           0;           0;          3;Terminales                                        ;SAM S7500                                         
2015-11-18;         47;Samsung                                           ;Smarthphones y Masivos;               23;          15;                 2;              17;          40;S.C.                ;S.C.                ;           0;           0;          3;Terminales                                        ;SAM S7560                                         
2015-11-18;         47;Samsung                                           ;Smarthphones y Masivos;              195;          28;                 1;              29;         224;S.C.                ;S.C.                ;           0;           0;          3;Terminales                                        ;SAM S7580                                         
2015-11-19;         47;Samsung                                           ;iPhone y Premium      ;               11;          44;                 0;              44;          55;176,0               ;220,0               ;           1;           1;          4;Terminales                                        ;SAM GLXY Alpha                                    
2015-11-19;         47;Samsung                                           ;iPhone y Premium      ;               30;          44;                 2;              46;          76;61,3                ;101,3               ;           0;           3;          4;Terminales                                        ;SAM GLXY S4                                       
2015-11-19;         47;Samsung                                           ;iPhone y Premium      ;               61;          98;                 8;             106;         167;8,2                 ;12,8                ;          27;          52;          4;Terminales                                        ;SAM GLXY S5                                       
2015-11-19;         47;Samsung                                           ;iPhone y Premium      ;              317;        1635;               383;            2018;        2335;23,7                ;27,4                ;          70;         341;          4;Terminales                                        ;SAM GLXY S6                                       
2015-11-19;         47;Samsung                                           ;iPhone y Premium      ;              658;        1267;                52;            1319;        1977;28,8                ;43,2                ;          42;         183;          4;Terminales                                        ;SAM GLXY S6 EDGE                                  
2015-11-19;         47;Samsung                                           ;iPhone y Premium      ;              302;         242;               422;             664;         966;35,4                ;51,5                ;          21;          75;          4;Terminales                                        ;SAM GLXY S6 EDGE PLUS                             
2015-11-19;         47;Samsung                                           ;iPhone y Premium      ;                0;           8;                 0;               8;           8;S.C.                ;S.C.                ;           0;           0;          4;Terminales                                        ;SAM I9100                                         
2015-11-19;         47;Samsung                                           ;iPhone y Premium      ;                9;          20;                 2;              22;          31;S.C.                ;S.C.                ;           0;           0;          4;Terminales                                        ;SAM I9195                                         
2015-11-19;         47;Samsung                                           ;iPhone y Premium      ;                0;           2;                 0;               2;           2;S.C.                ;S.C.                ;           0;           0;          4;Terminales                                        ;SAM I9250                                         
2015-11-19;         47;Samsung                                           ;iPhone y Premium      ;                4;          16;                 0;              16;          20;10,7                ;13,3                ;           1;           6;          4;Terminales                                        ;SAM Note 3 Neo                                    
2015-11-19;         47;Samsung                                           ;iPhone y Premium      ;              227;         193;                 3;             196;         423;60,3                ;130,2               ;           6;          13;          4;Terminales                                        ;SAM Note IV                                       
2015-11-19;         47;Samsung                                           ;iPhone y Premium      ;                0;           2;                 0;               2;           2;S.C.                ;S.C.                ;           0;           0;          4;Terminales                                        ;SAM Note N7000                                    
2015-11-19;         47;Samsung                                           ;iPhone y Premium      ;                1;           3;                 1;               4;           5;S.C.                ;S.C.                ;           0;           0;          4;Terminales                                        ;SAM Note N9005                                    
2015-11-19;         47;Samsung                                           ;Smarthphones y Masivos;                1;           0;                 0;               0;           1;S.C.                ;S.C.                ;           0;           0;          4;Terminales                                        ;SAM C276                                          
2015-11-19;         47;Samsung                                           ;Smarthphones y Masivos;                1;           5;                 0;               5;           6;S.C.                ;S.C.                ;           0;           0;          4;Terminales                                        ;SAM C3300                                         
2015-11-19;         47;Samsung                                           ;Smarthphones y Masivos;                2;           3;                 0;               3;           5;S.C.                ;S.C.                ;           0;           0;          4;Terminales                                        ;SAM C3310                                         
2015-11-19;         47;Samsung                                           ;Smarthphones y Masivos;                1;           0;                 0;               0;           1;S.C.                ;S.C.                ;           0;           0;          4;Terminales                                        ;SAM C3510                                         
2015-11-19;         47;Samsung                                           ;Smarthphones y Masivos;                0;           3;                 0;               3;           3;S.C.                ;S.C.                ;           0;           0;          4;Terminales                                        ;SAM C3520                                         
2015-11-19;         47;Samsung                                           ;Smarthphones y Masivos;               27;           0;                 0;               0;          27;S.C.                ;S.C.                ;           0;           0;          4;Terminales                                        ;SAM E1205                                         
2015-11-19;         47;Samsung                                           ;Smarthphones y Masivos;                2;           0;                 0;               0;           2;S.C.                ;S.C.                ;           0;           0;          4;Terminales                                        ;SAM E2121                                         
2015-11-19;         47;Samsung                                           ;Smarthphones y Masivos;               16;           0;                 0;               0;          16;S.C.                ;S.C.                ;           0;           0;          4;Terminales                                        ;SAM E2230                                         
2015-11-19;         47;Samsung                                           ;Smarthphones y Masivos;                2;           0;                 0;               0;           2;S.C.                ;S.C.                ;           0;           0;          4;Terminales                                        ;SAM E3210                                         
2015-11-19;         47;Samsung                                           ;Smarthphones y Masivos;                2;           0;                 0;               0;           2;S.C.                ;S.C.                ;           0;           0;          4;Terminales                                        ;SAM E3300                                         
2015-11-19;         47;Samsung                                           ;Smarthphones y Masivos;              108;           0;                 0;               0;         108;S.C.                ;S.C.                ;           0;           0;          4;Terminales                                        ;SAM Gear S R750                                   
2015-11-19;         47;Samsung                                           ;Smarthphones y Masivos;              107;         174;                 1;             175;         282;116,7               ;188,0               ;           2;           6;          4;Terminales                                        ;SAM GLXY A5                                       
2015-11-19;         47;Samsung                                           ;Smarthphones y Masivos;             3347;           0;                 0;               0;        3347;S.C.                ;S.C.                ;           0;           0;          4;Terminales                                        ;SAM GLXY Ace 4                                    
2015-11-19;         47;Samsung                                           ;Smarthphones y Masivos;              357;         474;                 1;             475;         832;63,3                ;110,9               ;          18;          30;          4;Terminales                                        ;SAM GLXY Ace 4 Lite                               
2015-11-19;         47;Samsung                                           ;Smarthphones y Masivos;             5097;        2385;              1806;            4191;        9288;39,4                ;87,2                ;         177;         426;          4;Terminales                                        ;SAM GLXY Ace 4 Neo                                
2015-11-19;         47;Samsung                                           ;Smarthphones y Masivos;              269;          96;                 2;              98;         367;S.C.                ;S.C.                ;           0;           0;          4;Terminales                                        ;SAM GLXY Core 2                                   
2015-11-19;         47;Samsung                                           ;Smarthphones y Masivos;              245;        1822;                 0;            1822;        2067;520,6               ;590,6               ;           3;          14;          4;Terminales                                        ;SAM GLXY Core Prime                               
2015-11-19;         47;Samsung                                           ;Smarthphones y Masivos;              606;        1539;                32;            1571;        2177;349,1               ;483,8               ;           2;          18;          4;Terminales                                        ;SAM GLXY Grand Prime LTE                          
2015-11-19;         47;Samsung                                           ;Smarthphones y Masivos;             4053;        6560;              1477;            8037;       12090;16,3                ;24,5                ;         418;        1971;          4;Terminales                                        ;SAM GLXY J1                                       
2015-11-19;         47;Samsung                                           ;Smarthphones y Masivos;            12266;        8071;              4327;           12398;       24664;11,6                ;23,1                ;         988;        4269;          4;Terminales                                        ;SAM GLXY J5                                       
2015-11-19;         47;Samsung                                           ;Smarthphones y Masivos;             2608;        2219;               357;            2576;        5184;132,1               ;265,8               ;          44;          78;          4;Terminales                                        ;SAM GLXY J7                                       
2015-11-19;         47;Samsung                                           ;Smarthphones y Masivos;                2;           4;                 1;               5;           7;S.C.                ;S.C.                ;           0;           0;          4;Terminales                                        ;SAM i8190                                         
2015-11-19;         47;Samsung                                           ;Smarthphones y Masivos;                3;           0;                 0;               0;           3;S.C.                ;S.C.                ;           0;           0;          4;Terminales                                        ;SAM I8260                                         
2015-11-19;         47;Samsung                                           ;Smarthphones y Masivos;               95;         127;                 4;             131;         226;104,8               ;180,8               ;           0;           5;          4;Terminales                                        ;SAM I8550                                         
2015-11-19;         47;Samsung                                           ;Smarthphones y Masivos;                1;           0;                 0;               0;           1;S.C.                ;S.C.                ;           0;           0;          4;Terminales                                        ;SAM i9070                                         
2015-11-19;         47;Samsung                                           ;Smarthphones y Masivos;              249;          21;                 1;              22;         271;S.C.                ;S.C.                ;           0;           0;          4;Terminales                                        ;SAM I9080                                         
2015-11-19;         47;Samsung                                           ;Smarthphones y Masivos;               32;          18;                 1;              19;          51;S.C.                ;S.C.                ;           0;           0;          4;Terminales                                        ;SAM I9300                                         
2015-11-19;         47;Samsung                                           ;Smarthphones y Masivos;                1;           3;                 0;               3;           4;S.C.                ;S.C.                ;           0;           0;          4;Terminales                                        ;SAM M3710                                         
2015-11-19;         47;Samsung                                           ;Smarthphones y Masivos;                0;           2;                 0;               2;           2;S.C.                ;S.C.                ;           0;           0;          4;Terminales                                        ;SAM S3770                                         
2015-11-19;         47;Samsung                                           ;Smarthphones y Masivos;                1;           0;                 0;               0;           1;S.C.                ;S.C.                ;           0;           0;          4;Terminales                                        ;SAM S5230                                         
2015-11-19;         47;Samsung                                           ;Smarthphones y Masivos;              267;         326;                 1;             327;         594;100,6               ;182,8               ;           8;          13;          4;Terminales                                        ;SAM S5310                                         
2015-11-19;         47;Samsung                                           ;Smarthphones y Masivos;                0;          14;                 1;              15;          15;S.C.                ;S.C.                ;           0;           0;          4;Terminales                                        ;SAM S5360                                         
2015-11-19;         47;Samsung                                           ;Smarthphones y Masivos;                7;           0;                 0;               0;           7;S.C.                ;S.C.                ;           0;           0;          4;Terminales                                        ;SAM S5560                                         
2015-11-19;         47;Samsung                                           ;Smarthphones y Masivos;                0;           1;                 0;               1;           1;S.C.                ;S.C.                ;           0;           0;          4;Terminales                                        ;SAM S5570                                         
2015-11-19;         47;Samsung                                           ;Smarthphones y Masivos;                1;           3;                 1;               4;           5;S.C.                ;S.C.                ;           0;           0;          4;Terminales                                        ;SAM S5830                                         
2015-11-19;         47;Samsung                                           ;Smarthphones y Masivos;               10;           0;                 0;               0;          10;S.C.                ;S.C.                ;           0;           0;          4;Terminales                                        ;SAM S6010                                         
2015-11-19;         47;Samsung                                           ;Smarthphones y Masivos;               49;          34;                 1;              35;          84;S.C.                ;S.C.                ;           0;           0;          4;Terminales                                        ;SAM S6310                                         
2015-11-19;         47;Samsung                                           ;Smarthphones y Masivos;                1;           0;                 0;               0;           1;S.C.                ;S.C.                ;           0;           0;          4;Terminales                                        ;SAM S6500                                         
2015-11-19;         47;Samsung                                           ;Smarthphones y Masivos;               71;          10;                 0;              10;          81;S.C.                ;S.C.                ;           0;           0;          4;Terminales                                        ;SAM S6810E                                        
2015-11-19;         47;Samsung                                           ;Smarthphones y Masivos;                4;          13;                 1;              14;          18;S.C.                ;S.C.                ;           0;           0;          4;Terminales                                        ;SAM S7500                                         
2015-11-19;         47;Samsung                                           ;Smarthphones y Masivos;               23;          16;                 1;              17;          40;S.C.                ;S.C.                ;           0;           0;          4;Terminales                                        ;SAM S7560                                         
2015-11-19;         47;Samsung                                           ;Smarthphones y Masivos;              195;          28;                 1;              29;         224;S.C.                ;S.C.                ;           0;           0;          4;Terminales                                        ;SAM S7580                                         
2015-11-20;         47;Samsung                                           ;iPhone y Premium      ;                0;           0;                 0;               0;           0;0,0                 ;0,0                 ;           0;           1;          5;Terminales                                        ;SAM GLXY Alpha                                    
2015-11-20;         47;Samsung                                           ;iPhone y Premium      ;                0;           0;                 0;               0;           0;0,0                 ;0,0                 ;           1;           4;          5;Terminales                                        ;SAM GLXY S4                                       
2015-11-20;         47;Samsung                                           ;iPhone y Premium      ;                0;           0;                 0;               0;           0;0,0                 ;0,0                 ;          32;          84;          5;Terminales                                        ;SAM GLXY S5                                       
2015-11-20;         47;Samsung                                           ;iPhone y Premium      ;                0;           0;                 0;               0;           0;0,0                 ;0,0                 ;         116;         457;          5;Terminales                                        ;SAM GLXY S6                                       
2015-11-20;         47;Samsung                                           ;iPhone y Premium      ;                0;           0;                 0;               0;           0;0,0                 ;0,0                 ;          81;         264;          5;Terminales                                        ;SAM GLXY S6 EDGE                                  
2015-11-20;         47;Samsung                                           ;iPhone y Premium      ;                0;           0;                 0;               0;           0;0,0                 ;0,0                 ;          43;         118;          5;Terminales                                        ;SAM GLXY S6 EDGE PLUS                             
2015-11-20;         47;Samsung                                           ;iPhone y Premium      ;                0;           0;                 0;               0;           0;0,0                 ;0,0                 ;           4;          10;          5;Terminales                                        ;SAM Note 3 Neo                                    
2015-11-20;         47;Samsung                                           ;iPhone y Premium      ;                0;           0;                 0;               0;           0;0,0                 ;0,0                 ;           5;          18;          5;Terminales                                        ;SAM Note IV                                       
2015-11-20;         47;Samsung                                           ;Smarthphones y Masivos;                0;           0;                 0;               0;           0;0,0                 ;0,0                 ;           3;           9;          5;Terminales                                        ;SAM GLXY A5                                       
2015-11-20;         47;Samsung                                           ;Smarthphones y Masivos;                0;           0;                 0;               0;           0;0,0                 ;0,0                 ;           5;          35;          5;Terminales                                        ;SAM GLXY Ace 4 Lite                               
2015-11-20;         47;Samsung                                           ;Smarthphones y Masivos;                0;           0;                 0;               0;           0;0,0                 ;0,0                 ;         140;         566;          5;Terminales                                        ;SAM GLXY Ace 4 Neo                                
2015-11-20;         47;Samsung                                           ;Smarthphones y Masivos;                0;           0;                 0;               0;           0;0,0                 ;0,0                 ;           4;          18;          5;Terminales                                        ;SAM GLXY Core Prime                               
2015-11-20;         47;Samsung                                           ;Smarthphones y Masivos;                0;           0;                 0;               0;           0;0,0                 ;0,0                 ;           1;          19;          5;Terminales                                        ;SAM GLXY Grand Prime LTE                          
2015-11-20;         47;Samsung                                           ;Smarthphones y Masivos;                0;           0;                 0;               0;           0;0,0                 ;0,0                 ;         690;        2661;          5;Terminales                                        ;SAM GLXY J1                                       
2015-11-20;         47;Samsung                                           ;Smarthphones y Masivos;                0;           0;                 0;               0;           0;0,0                 ;0,0                 ;        1124;        5393;          5;Terminales                                        ;SAM GLXY J5                                       
2015-11-20;         47;Samsung                                           ;Smarthphones y Masivos;                0;           0;                 0;               0;           0;0,0                 ;0,0                 ;          77;         155;          5;Terminales                                        ;SAM GLXY J7                                       
2015-11-20;         47;Samsung                                           ;Smarthphones y Masivos;                0;           0;                 0;               0;           0;0,0                 ;0,0                 ;           2;           7;          5;Terminales                                        ;SAM I8550                                         
2015-11-20;         47;Samsung                                           ;Smarthphones y Masivos;                0;           0;                 0;               0;           0;0,0                 ;0,0                 ;           3;          16;          5;Terminales                                        ;SAM S5310                                         
2015-11-21;         47;Samsung                                           ;iPhone y Premium      ;                0;           0;                 0;               0;           0;0,0                 ;0,0                 ;           0;           1;          6;Terminales                                        ;SAM GLXY Alpha                                    
2015-11-21;         47;Samsung                                           ;iPhone y Premium      ;                0;           0;                 0;               0;           0;0,0                 ;0,0                 ;           0;           4;          6;Terminales                                        ;SAM GLXY S4                                       
2015-11-21;         47;Samsung                                           ;iPhone y Premium      ;                0;           0;                 0;               0;           0;0,0                 ;0,0                 ;          28;         112;          6;Terminales                                        ;SAM GLXY S5                                       
2015-11-21;         47;Samsung                                           ;iPhone y Premium      ;                0;           0;                 0;               0;           0;0,0                 ;0,0                 ;          17;         474;          6;Terminales                                        ;SAM GLXY S6                                       
2015-11-21;         47;Samsung                                           ;iPhone y Premium      ;                0;           0;                 0;               0;           0;0,0                 ;0,0                 ;          13;         277;          6;Terminales                                        ;SAM GLXY S6 EDGE                                  
2015-11-21;         47;Samsung                                           ;iPhone y Premium      ;                0;           0;                 0;               0;           0;0,0                 ;0,0                 ;           1;         119;          6;Terminales                                        ;SAM GLXY S6 EDGE PLUS                             
2015-11-21;         47;Samsung                                           ;iPhone y Premium      ;                0;           0;                 0;               0;           0;0,0                 ;0,0                 ;           0;          10;          6;Terminales                                        ;SAM Note 3 Neo                                    
2015-11-21;         47;Samsung                                           ;iPhone y Premium      ;                0;           0;                 0;               0;           0;0,0                 ;0,0                 ;           0;          18;          6;Terminales                                        ;SAM Note IV                                       
2015-11-21;         47;Samsung                                           ;Smarthphones y Masivos;                0;           0;                 0;               0;           0;0,0                 ;0,0                 ;           1;          10;          6;Terminales                                        ;SAM GLXY A5                                       
2015-11-21;         47;Samsung                                           ;Smarthphones y Masivos;                0;           0;                 0;               0;           0;0,0                 ;0,0                 ;           0;          35;          6;Terminales                                        ;SAM GLXY Ace 4 Lite                               
2015-11-21;         47;Samsung                                           ;Smarthphones y Masivos;                0;           0;                 0;               0;           0;0,0                 ;0,0                 ;           5;         571;          6;Terminales                                        ;SAM GLXY Ace 4 Neo                                
2015-11-21;         47;Samsung                                           ;Smarthphones y Masivos;                0;           0;                 0;               0;           0;0,0                 ;0,0                 ;           1;          19;          6;Terminales                                        ;SAM GLXY Core Prime                               
2015-11-21;         47;Samsung                                           ;Smarthphones y Masivos;                0;           0;                 0;               0;           0;0,0                 ;0,0                 ;           2;          21;          6;Terminales                                        ;SAM GLXY Grand Prime LTE                          
2015-11-21;         47;Samsung                                           ;Smarthphones y Masivos;                0;           0;                 0;               0;           0;0,0                 ;0,0                 ;         138;        2799;          6;Terminales                                        ;SAM GLXY J1                                       
2015-11-21;         47;Samsung                                           ;Smarthphones y Masivos;                0;           0;                 0;               0;           0;0,0                 ;0,0                 ;         272;        5665;          6;Terminales                                        ;SAM GLXY J5                                       
2015-11-21;         47;Samsung                                           ;Smarthphones y Masivos;                0;           0;                 0;               0;           0;0,0                 ;0,0                 ;          23;         178;          6;Terminales                                        ;SAM GLXY J7                                       
2015-11-21;         47;Samsung                                           ;Smarthphones y Masivos;                0;           0;                 0;               0;           0;0,0                 ;0,0                 ;           0;           7;          6;Terminales                                        ;SAM I8550                                         
2015-11-21;         47;Samsung                                           ;Smarthphones y Masivos;                0;           0;                 0;               0;           0;0,0                 ;0,0                 ;           0;          16;          6;Terminales                                        ;SAM S5310                                         
2015-11-22;         47;Samsung                                           ;iPhone y Premium      ;               11;          44;                 0;              44;          55;308,0               ;385,0               ;           0;           1;          7;Terminales                                        ;SAM GLXY Alpha                                    
2015-11-22;         47;Samsung                                           ;iPhone y Premium      ;               30;          43;                 2;              45;          75;78,8                ;131,3               ;           0;           4;          7;Terminales                                        ;SAM GLXY S4                                       
2015-11-22;         47;Samsung                                           ;iPhone y Premium      ;               61;          97;                 8;             105;         166;6,0                 ;9,4                 ;          11;         123;          7;Terminales                                        ;SAM GLXY S5                                       
2015-11-22;         47;Samsung                                           ;iPhone y Premium      ;              663;        1719;               173;            1892;        2555;27,6                ;37,3                ;           5;         479;          7;Terminales                                        ;SAM GLXY S6                                       
2015-11-22;         47;Samsung                                           ;iPhone y Premium      ;              854;        1192;                52;            1244;        2098;31,0                ;52,3                ;           4;         281;          7;Terminales                                        ;SAM GLXY S6 EDGE                                  
2015-11-22;         47;Samsung                                           ;iPhone y Premium      ;              424;         494;               134;             628;        1052;36,9                ;61,9                ;           0;         119;          7;Terminales                                        ;SAM GLXY S6 EDGE PLUS                             
2015-11-22;         47;Samsung                                           ;iPhone y Premium      ;                0;           8;                 0;               8;           8;S.C.                ;S.C.                ;           0;           0;          7;Terminales                                        ;SAM I9100                                         
2015-11-22;         47;Samsung                                           ;iPhone y Premium      ;                9;          20;                 2;              22;          31;S.C.                ;S.C.                ;           0;           0;          7;Terminales                                        ;SAM I9195                                         
2015-11-22;         47;Samsung                                           ;iPhone y Premium      ;                0;           2;                 0;               2;           2;S.C.                ;S.C.                ;           0;           0;          7;Terminales                                        ;SAM I9250                                         
2015-11-22;         47;Samsung                                           ;iPhone y Premium      ;                4;          12;                 0;              12;          16;8,4                 ;11,2                ;           0;          10;          7;Terminales                                        ;SAM Note 3 Neo                                    
2015-11-22;         47;Samsung                                           ;iPhone y Premium      ;              227;         189;                 2;             191;         418;74,3                ;162,6               ;           0;          18;          7;Terminales                                        ;SAM Note IV                                       
2015-11-22;         47;Samsung                                           ;iPhone y Premium      ;                0;           2;                 0;               2;           2;S.C.                ;S.C.                ;           0;           0;          7;Terminales                                        ;SAM Note N7000                                    
2015-11-22;         47;Samsung                                           ;iPhone y Premium      ;                1;           3;                 1;               4;           5;S.C.                ;S.C.                ;           0;           0;          7;Terminales                                        ;SAM Note N9005                                    
2015-11-22;         47;Samsung                                           ;Smarthphones y Masivos;                1;           0;                 0;               0;           1;S.C.                ;S.C.                ;           0;           0;          7;Terminales                                        ;SAM C276                                          
2015-11-22;         47;Samsung                                           ;Smarthphones y Masivos;                1;           5;                 0;               5;           6;S.C.                ;S.C.                ;           0;           0;          7;Terminales                                        ;SAM C3300                                         
2015-11-22;         47;Samsung                                           ;Smarthphones y Masivos;                2;           3;                 0;               3;           5;S.C.                ;S.C.                ;           0;           0;          7;Terminales                                        ;SAM C3310                                         
2015-11-22;         47;Samsung                                           ;Smarthphones y Masivos;                1;           0;                 0;               0;           1;S.C.                ;S.C.                ;           0;           0;          7;Terminales                                        ;SAM C3510                                         
2015-11-22;         47;Samsung                                           ;Smarthphones y Masivos;                0;           3;                 0;               3;           3;S.C.                ;S.C.                ;           0;           0;          7;Terminales                                        ;SAM C3520                                         
2015-11-22;         47;Samsung                                           ;Smarthphones y Masivos;               27;           0;                 0;               0;          27;S.C.                ;S.C.                ;           0;           0;          7;Terminales                                        ;SAM E1205                                         
2015-11-22;         47;Samsung                                           ;Smarthphones y Masivos;                2;           0;                 0;               0;           2;S.C.                ;S.C.                ;           0;           0;          7;Terminales                                        ;SAM E2121                                         
2015-11-22;         47;Samsung                                           ;Smarthphones y Masivos;               16;           0;                 0;               0;          16;S.C.                ;S.C.                ;           0;           0;          7;Terminales                                        ;SAM E2230                                         
2015-11-22;         47;Samsung                                           ;Smarthphones y Masivos;                2;           0;                 0;               0;           2;S.C.                ;S.C.                ;           0;           0;          7;Terminales                                        ;SAM E3210                                         
2015-11-22;         47;Samsung                                           ;Smarthphones y Masivos;                2;           0;                 0;               0;           2;S.C.                ;S.C.                ;           0;           0;          7;Terminales                                        ;SAM E3300                                         
2015-11-22;         47;Samsung                                           ;Smarthphones y Masivos;              108;           0;                 0;               0;         108;S.C.                ;S.C.                ;           0;           0;          7;Terminales                                        ;SAM Gear S R750                                   
2015-11-22;         47;Samsung                                           ;Smarthphones y Masivos;              107;         170;                 1;             171;         278;119,7               ;194,6               ;           0;          10;          7;Terminales                                        ;SAM GLXY A5                                       
2015-11-22;         47;Samsung                                           ;Smarthphones y Masivos;             3193;           0;                 0;               0;        3193;S.C.                ;S.C.                ;           0;           0;          7;Terminales                                        ;SAM GLXY Ace 4                                    
2015-11-22;         47;Samsung                                           ;Smarthphones y Masivos;              357;         467;                 2;             469;         826;93,8                ;165,2               ;           0;          35;          7;Terminales                                        ;SAM GLXY Ace 4 Lite                               
2015-11-22;         47;Samsung                                           ;Smarthphones y Masivos;             4264;        2225;              1801;            4026;        8290;49,3                ;101,5               ;           1;         572;          7;Terminales                                        ;SAM GLXY Ace 4 Neo                                
2015-11-22;         47;Samsung                                           ;Smarthphones y Masivos;              269;          96;                 2;              98;         367;S.C.                ;S.C.                ;           0;           0;          7;Terminales                                        ;SAM GLXY Core 2                                   
2015-11-22;         47;Samsung                                           ;Smarthphones y Masivos;              245;        1814;                 0;            1814;        2059;668,3               ;758,6               ;           0;          19;          7;Terminales                                        ;SAM GLXY Core Prime                               
2015-11-22;         47;Samsung                                           ;Smarthphones y Masivos;              606;        1536;                32;            1568;        2174;498,9               ;691,7               ;           1;          22;          7;Terminales                                        ;SAM GLXY Grand Prime LTE                          
2015-11-22;         47;Samsung                                           ;Smarthphones y Masivos;             2915;        6303;              1989;            8292;       11207;20,4                ;27,6                ;          45;        2844;          7;Terminales                                        ;SAM GLXY J1                                       
2015-11-22;         47;Samsung                                           ;Smarthphones y Masivos;            10505;        8758;              3913;           12671;       23176;15,4                ;28,3                ;          76;        5741;          7;Terminales                                        ;SAM GLXY J5                                       
2015-11-22;         47;Samsung                                           ;Smarthphones y Masivos;             2563;        2283;               198;            2481;        5044;92,9                ;188,8               ;           9;         187;          7;Terminales                                        ;SAM GLXY J7                                       
2015-11-22;         47;Samsung                                           ;Smarthphones y Masivos;                2;           4;                 1;               5;           7;S.C.                ;S.C.                ;           0;           0;          7;Terminales                                        ;SAM i8190                                         
2015-11-22;         47;Samsung                                           ;Smarthphones y Masivos;                3;           0;                 0;               0;           3;S.C.                ;S.C.                ;           0;           0;          7;Terminales                                        ;SAM I8260                                         
2015-11-22;         47;Samsung                                           ;Smarthphones y Masivos;               95;         126;                 4;             130;         225;130,0               ;225,0               ;           0;           7;          7;Terminales                                        ;SAM I8550                                         
2015-11-22;         47;Samsung                                           ;Smarthphones y Masivos;                1;           0;                 0;               0;           1;S.C.                ;S.C.                ;           0;           0;          7;Terminales                                        ;SAM i9070                                         
2015-11-22;         47;Samsung                                           ;Smarthphones y Masivos;              249;          21;                 1;              22;         271;S.C.                ;S.C.                ;           0;           0;          7;Terminales                                        ;SAM I9080                                         
2015-11-22;         47;Samsung                                           ;Smarthphones y Masivos;               32;          18;                 1;              19;          51;S.C.                ;S.C.                ;           0;           0;          7;Terminales                                        ;SAM I9300                                         
2015-11-22;         47;Samsung                                           ;Smarthphones y Masivos;                1;           3;                 0;               3;           4;S.C.                ;S.C.                ;           0;           0;          7;Terminales                                        ;SAM M3710                                         
2015-11-22;         47;Samsung                                           ;Smarthphones y Masivos;                0;           2;                 0;               2;           2;S.C.                ;S.C.                ;           0;           0;          7;Terminales                                        ;SAM S3770                                         
2015-11-22;         47;Samsung                                           ;Smarthphones y Masivos;                1;           0;                 0;               0;           1;S.C.                ;S.C.                ;           0;           0;          7;Terminales                                        ;SAM S5230                                         
2015-11-22;         47;Samsung                                           ;Smarthphones y Masivos;              267;         322;                 1;             323;         590;141,3               ;258,1               ;           0;          16;          7;Terminales                                        ;SAM S5310                                         
2015-11-22;         47;Samsung                                           ;Smarthphones y Masivos;                0;          14;                 1;              15;          15;S.C.                ;S.C.                ;           0;           0;          7;Terminales                                        ;SAM S5360                                         
2015-11-22;         47;Samsung                                           ;Smarthphones y Masivos;                7;           0;                 0;               0;           7;S.C.                ;S.C.                ;           0;           0;          7;Terminales                                        ;SAM S5560                                         
2015-11-22;         47;Samsung                                           ;Smarthphones y Masivos;                0;           1;                 0;               1;           1;S.C.                ;S.C.                ;           0;           0;          7;Terminales                                        ;SAM S5570                                         
2015-11-22;         47;Samsung                                           ;Smarthphones y Masivos;                1;           3;                 1;               4;           5;S.C.                ;S.C.                ;           0;           0;          7;Terminales                                        ;SAM S5830                                         
2015-11-22;         47;Samsung                                           ;Smarthphones y Masivos;               10;           0;                 0;               0;          10;S.C.                ;S.C.                ;           0;           0;          7;Terminales                                        ;SAM S6010                                         
2015-11-22;         47;Samsung                                           ;Smarthphones y Masivos;               49;          34;                 1;              35;          84;S.C.                ;S.C.                ;           0;           0;          7;Terminales                                        ;SAM S6310                                         
2015-11-22;         47;Samsung                                           ;Smarthphones y Masivos;                1;           0;                 0;               0;           1;S.C.                ;S.C.                ;           0;           0;          7;Terminales                                        ;SAM S6500                                         
2015-11-22;         47;Samsung                                           ;Smarthphones y Masivos;               71;          10;                 0;              10;          81;S.C.                ;S.C.                ;           0;           0;          7;Terminales                                        ;SAM S6810E                                        
2015-11-22;         47;Samsung                                           ;Smarthphones y Masivos;                4;          13;                 1;              14;          18;S.C.                ;S.C.                ;           0;           0;          7;Terminales                                        ;SAM S7500                                         
2015-11-22;         47;Samsung                                           ;Smarthphones y Masivos;               23;          16;                 1;              17;          40;S.C.                ;S.C.                ;           0;           0;          7;Terminales                                        ;SAM S7560                                         
2015-11-22;         47;Samsung                                           ;Smarthphones y Masivos;              195;          28;                 1;              29;         224;S.C.                ;S.C.                ;           0;           0;          7;Terminales                                        ;SAM S7580                                         
2015-11-23;         48;Samsung                                           ;iPhone y Premium      ;               37;          44;                 0;              44;          81;S.C.                ;S.C.                ;           0;           0;          1;Terminales                                        ;SAM GLXY Alpha                                    
2015-11-23;         48;Samsung                                           ;iPhone y Premium      ;               30;          42;                 2;              44;          74;44,0                ;74,0                ;           1;           1;          1;Terminales                                        ;SAM GLXY S4                                       
2015-11-23;         48;Samsung                                           ;iPhone y Premium      ;               57;          98;                17;             115;         172;6,8                 ;10,1                ;          17;          17;          1;Terminales                                        ;SAM GLXY S5                                       
2015-11-23;         48;Samsung                                           ;iPhone y Premium      ;             1166;        1703;               125;            1828;        2994;30,5                ;49,9                ;          60;          60;          1;Terminales                                        ;SAM GLXY S6                                       
2015-11-23;         48;Samsung                                           ;iPhone y Premium      ;              527;        1151;               369;            1520;        2047;28,1                ;37,9                ;          54;          54;          1;Terminales                                        ;SAM GLXY S6 EDGE                                  
2015-11-23;         48;Samsung                                           ;iPhone y Premium      ;              424;         479;               104;             583;        1007;13,6                ;23,4                ;          43;          43;          1;Terminales                                        ;SAM GLXY S6 EDGE PLUS                             
2015-11-23;         48;Samsung                                           ;iPhone y Premium      ;                0;           8;                 0;               8;           8;S.C.                ;S.C.                ;           0;           0;          1;Terminales                                        ;SAM I9100                                         
2015-11-23;         48;Samsung                                           ;iPhone y Premium      ;                9;          20;                 2;              22;          31;S.C.                ;S.C.                ;           0;           0;          1;Terminales                                        ;SAM I9195                                         
2015-11-23;         48;Samsung                                           ;iPhone y Premium      ;                0;           2;                 0;               2;           2;S.C.                ;S.C.                ;           0;           0;          1;Terminales                                        ;SAM I9250                                         
2015-11-23;         48;Samsung                                           ;iPhone y Premium      ;               10;          12;                 0;              12;          22;S.C.                ;S.C.                ;           0;           0;          1;Terminales                                        ;SAM Note 3 Neo                                    
2015-11-23;         48;Samsung                                           ;iPhone y Premium      ;              237;         186;                 3;             189;         426;94,5                ;213,0               ;           2;           2;          1;Terminales                                        ;SAM Note IV                                       
2015-11-23;         48;Samsung                                           ;iPhone y Premium      ;                0;           2;                 0;               2;           2;S.C.                ;S.C.                ;           0;           0;          1;Terminales                                        ;SAM Note N7000                                    
2015-11-23;         48;Samsung                                           ;iPhone y Premium      ;                1;           3;                 1;               4;           5;S.C.                ;S.C.                ;           0;           0;          1;Terminales                                        ;SAM Note N9005                                    
2015-11-23;         48;Samsung                                           ;Smarthphones y Masivos;                1;           0;                 0;               0;           1;S.C.                ;S.C.                ;           0;           0;          1;Terminales                                        ;SAM C276                                          
2015-11-23;         48;Samsung                                           ;Smarthphones y Masivos;                1;           5;                 0;               5;           6;S.C.                ;S.C.                ;           0;           0;          1;Terminales                                        ;SAM C3300                                         
2015-11-23;         48;Samsung                                           ;Smarthphones y Masivos;                2;           3;                 0;               3;           5;S.C.                ;S.C.                ;           0;           0;          1;Terminales                                        ;SAM C3310                                         
2015-11-23;         48;Samsung                                           ;Smarthphones y Masivos;                1;           0;                 0;               0;           1;S.C.                ;S.C.                ;           0;           0;          1;Terminales                                        ;SAM C3510                                         
2015-11-23;         48;Samsung                                           ;Smarthphones y Masivos;                0;           3;                 0;               3;           3;S.C.                ;S.C.                ;           0;           0;          1;Terminales                                        ;SAM C3520                                         
2015-11-23;         48;Samsung                                           ;Smarthphones y Masivos;               27;           0;                 0;               0;          27;S.C.                ;S.C.                ;           0;           0;          1;Terminales                                        ;SAM E1205                                         
2015-11-23;         48;Samsung                                           ;Smarthphones y Masivos;                2;           0;                 0;               0;           2;S.C.                ;S.C.                ;           0;           0;          1;Terminales                                        ;SAM E2121                                         
2015-11-23;         48;Samsung                                           ;Smarthphones y Masivos;               16;           0;                 0;               0;          16;S.C.                ;S.C.                ;           0;           0;          1;Terminales                                        ;SAM E2230                                         
2015-11-23;         48;Samsung                                           ;Smarthphones y Masivos;                2;           0;                 0;               0;           2;S.C.                ;S.C.                ;           0;           0;          1;Terminales                                        ;SAM E3210                                         
2015-11-23;         48;Samsung                                           ;Smarthphones y Masivos;                2;           0;                 0;               0;           2;S.C.                ;S.C.                ;           0;           0;          1;Terminales                                        ;SAM E3300                                         
2015-11-23;         48;Samsung                                           ;Smarthphones y Masivos;              108;           0;                 0;               0;         108;S.C.                ;S.C.                ;           0;           0;          1;Terminales                                        ;SAM Gear S R750                                   
2015-11-23;         48;Samsung                                           ;Smarthphones y Masivos;              111;         170;                 1;             171;         282;S.C.                ;S.C.                ;           0;           0;          1;Terminales                                        ;SAM GLXY A5                                       
2015-11-23;         48;Samsung                                           ;Smarthphones y Masivos;             3193;           0;                 0;               0;        3193;S.C.                ;S.C.                ;           0;           0;          1;Terminales                                        ;SAM GLXY Ace 4                                    
2015-11-23;         48;Samsung                                           ;Smarthphones y Masivos;              383;         463;                 2;             465;         848;116,3               ;212,0               ;           4;           4;          1;Terminales                                        ;SAM GLXY Ace 4 Lite                               
2015-11-23;         48;Samsung                                           ;Smarthphones y Masivos;             4309;        2758;              1137;            3895;        8204;25,6                ;54,0                ;         152;         152;          1;Terminales                                        ;SAM GLXY Ace 4 Neo                                
2015-11-23;         48;Samsung                                           ;Smarthphones y Masivos;              274;          96;                 2;              98;         372;S.C.                ;S.C.                ;           0;           0;          1;Terminales                                        ;SAM GLXY Core 2                                   
2015-11-23;         48;Samsung                                           ;Smarthphones y Masivos;              265;        1815;                 0;            1815;        2080;S.C.                ;S.C.                ;           0;           0;          1;Terminales                                        ;SAM GLXY Core Prime                               
2015-11-23;         48;Samsung                                           ;Smarthphones y Masivos;              663;        1525;                40;            1565;        2228;391,3               ;557,0               ;           4;           4;          1;Terminales                                        ;SAM GLXY Grand Prime LTE                          
2015-11-23;         48;Samsung                                           ;Smarthphones y Masivos;             2518;        6498;              1668;            8166;       10684;15,6                ;20,5                ;         522;         522;          1;Terminales                                        ;SAM GLXY J1                                       
2015-11-23;         48;Samsung                                           ;Smarthphones y Masivos;             9568;        9380;              3103;           12483;       22051;11,1                ;19,5                ;        1129;        1129;          1;Terminales                                        ;SAM GLXY J5                                       
2015-11-23;         48;Samsung                                           ;Smarthphones y Masivos;             2553;        2346;                78;            2424;        4977;36,7                ;75,4                ;          66;          66;          1;Terminales                                        ;SAM GLXY J7                                       
2015-11-23;         48;Samsung                                           ;Smarthphones y Masivos;                2;           4;                 1;               5;           7;S.C.                ;S.C.                ;           0;           0;          1;Terminales                                        ;SAM i8190                                         
2015-11-23;         48;Samsung                                           ;Smarthphones y Masivos;                3;           0;                 0;               0;           3;S.C.                ;S.C.                ;           0;           0;          1;Terminales                                        ;SAM I8260                                         
2015-11-23;         48;Samsung                                           ;Smarthphones y Masivos;               95;         123;                 4;             127;         222;42,3                ;74,0                ;           3;           3;          1;Terminales                                        ;SAM I8550                                         
2015-11-23;         48;Samsung                                           ;Smarthphones y Masivos;                1;           0;                 0;               0;           1;S.C.                ;S.C.                ;           0;           0;          1;Terminales                                        ;SAM i9070                                         
2015-11-23;         48;Samsung                                           ;Smarthphones y Masivos;              249;          21;                 1;              22;         271;S.C.                ;S.C.                ;           0;           0;          1;Terminales                                        ;SAM I9080                                         
2015-11-23;         48;Samsung                                           ;Smarthphones y Masivos;               32;          19;                 0;              19;          51;S.C.                ;S.C.                ;           0;           0;          1;Terminales                                        ;SAM I9300                                         
2015-11-23;         48;Samsung                                           ;Smarthphones y Masivos;                1;           3;                 0;               3;           4;S.C.                ;S.C.                ;           0;           0;          1;Terminales                                        ;SAM M3710                                         
2015-11-23;         48;Samsung                                           ;Smarthphones y Masivos;                0;           2;                 0;               2;           2;S.C.                ;S.C.                ;           0;           0;          1;Terminales                                        ;SAM S3770                                         
2015-11-23;         48;Samsung                                           ;Smarthphones y Masivos;                1;           0;                 0;               0;           1;S.C.                ;S.C.                ;           0;           0;          1;Terminales                                        ;SAM S5230                                         
2015-11-23;         48;Samsung                                           ;Smarthphones y Masivos;              307;         321;                 0;             321;         628;160,5               ;314,0               ;           2;           2;          1;Terminales                                        ;SAM S5310                                         
2015-11-23;         48;Samsung                                           ;Smarthphones y Masivos;                0;          14;                 1;              15;          15;S.C.                ;S.C.                ;           0;           0;          1;Terminales                                        ;SAM S5360                                         
2015-11-23;         48;Samsung                                           ;Smarthphones y Masivos;                7;           0;                 0;               0;           7;S.C.                ;S.C.                ;           0;           0;          1;Terminales                                        ;SAM S5560                                         
2015-11-23;         48;Samsung                                           ;Smarthphones y Masivos;                0;           1;                 0;               1;           1;S.C.                ;S.C.                ;           0;           0;          1;Terminales                                        ;SAM S5570                                         
2015-11-23;         48;Samsung                                           ;Smarthphones y Masivos;                3;           3;                 1;               4;           7;S.C.                ;S.C.                ;           0;           0;          1;Terminales                                        ;SAM S5830                                         
2015-11-23;         48;Samsung                                           ;Smarthphones y Masivos;               10;           0;                 0;               0;          10;S.C.                ;S.C.                ;           0;           0;          1;Terminales                                        ;SAM S6010                                         
2015-11-23;         48;Samsung                                           ;Smarthphones y Masivos;               55;          34;                 1;              35;          90;S.C.                ;S.C.                ;           0;           0;          1;Terminales                                        ;SAM S6310                                         
2015-11-23;         48;Samsung                                           ;Smarthphones y Masivos;                1;           0;                 0;               0;           1;S.C.                ;S.C.                ;           0;           0;          1;Terminales                                        ;SAM S6500                                         
2015-11-23;         48;Samsung                                           ;Smarthphones y Masivos;               71;          10;                 0;              10;          81;S.C.                ;S.C.                ;           0;           0;          1;Terminales                                        ;SAM S6810E                                        
2015-11-23;         48;Samsung                                           ;Smarthphones y Masivos;                4;          13;                 1;              14;          18;S.C.                ;S.C.                ;           0;           0;          1;Terminales                                        ;SAM S7500                                         
2015-11-23;         48;Samsung                                           ;Smarthphones y Masivos;               30;          16;                 1;              17;          47;S.C.                ;S.C.                ;           0;           0;          1;Terminales                                        ;SAM S7560                                         
2015-11-23;         48;Samsung                                           ;Smarthphones y Masivos;              197;          28;                 1;              29;         226;S.C.                ;S.C.                ;           0;           0;          1;Terminales                                        ;SAM S7580                                         
2015-11-24;         48;Samsung                                           ;iPhone y Premium      ;               37;          48;                 0;              48;          85;S.C.                ;S.C.                ;           0;           0;          2;Terminales                                        ;SAM GLXY Alpha                                    
2015-11-24;         48;Samsung                                           ;iPhone y Premium      ;               30;          42;                 2;              44;          74;88,0                ;148,0               ;           0;           1;          2;Terminales                                        ;SAM GLXY S4                                       
2015-11-24;         48;Samsung                                           ;iPhone y Premium      ;               57;          98;                17;             115;         172;7,9                 ;11,9                ;          12;          29;          2;Terminales                                        ;SAM GLXY S5                                       
2015-11-24;         48;Samsung                                           ;iPhone y Premium      ;              966;        1731;               114;            1845;        2811;25,6                ;39,0                ;          84;         144;          2;Terminales                                        ;SAM GLXY S6                                       
2015-11-24;         48;Samsung                                           ;iPhone y Premium      ;              509;        1171;               317;            1488;        1997;29,5                ;39,5                ;          47;         101;          2;Terminales                                        ;SAM GLXY S6 EDGE                                  
2015-11-24;         48;Samsung                                           ;iPhone y Premium      ;              377;         543;                53;             596;         973;15,7                ;25,6                ;          33;          76;          2;Terminales                                        ;SAM GLXY S6 EDGE PLUS                             
2015-11-24;         48;Samsung                                           ;iPhone y Premium      ;                0;           8;                 0;               8;           8;S.C.                ;S.C.                ;           0;           0;          2;Terminales                                        ;SAM I9100                                         
2015-11-24;         48;Samsung                                           ;iPhone y Premium      ;                9;          20;                 2;              22;          31;S.C.                ;S.C.                ;           0;           0;          2;Terminales                                        ;SAM I9195                                         
2015-11-24;         48;Samsung                                           ;iPhone y Premium      ;                0;           2;                 0;               2;           2;S.C.                ;S.C.                ;           0;           0;          2;Terminales                                        ;SAM I9250                                         
2015-11-24;         48;Samsung                                           ;iPhone y Premium      ;               10;          12;                 0;              12;          22;S.C.                ;S.C.                ;           0;           0;          2;Terminales                                        ;SAM Note 3 Neo                                    
2015-11-24;         48;Samsung                                           ;iPhone y Premium      ;              230;         187;                 7;             194;         424;77,6                ;169,6               ;           3;           5;          2;Terminales                                        ;SAM Note IV                                       
2015-11-24;         48;Samsung                                           ;iPhone y Premium      ;                0;           2;                 0;               2;           2;S.C.                ;S.C.                ;           0;           0;          2;Terminales                                        ;SAM Note N7000                                    
2015-11-24;         48;Samsung                                           ;iPhone y Premium      ;                1;           3;                 1;               4;           5;S.C.                ;S.C.                ;           0;           0;          2;Terminales                                        ;SAM Note N9005                                    
2015-11-24;         48;Samsung                                           ;Smarthphones y Masivos;                1;           0;                 0;               0;           1;S.C.                ;S.C.                ;           0;           0;          2;Terminales                                        ;SAM C276                                          
2015-11-24;         48;Samsung                                           ;Smarthphones y Masivos;                1;           5;                 0;               5;           6;S.C.                ;S.C.                ;           0;           0;          2;Terminales                                        ;SAM C3300                                         
2015-11-24;         48;Samsung                                           ;Smarthphones y Masivos;                2;           3;                 0;               3;           5;S.C.                ;S.C.                ;           0;           0;          2;Terminales                                        ;SAM C3310                                         
2015-11-24;         48;Samsung                                           ;Smarthphones y Masivos;                1;           0;                 0;               0;           1;S.C.                ;S.C.                ;           0;           0;          2;Terminales                                        ;SAM C3510                                         
2015-11-24;         48;Samsung                                           ;Smarthphones y Masivos;                0;           3;                 0;               3;           3;S.C.                ;S.C.                ;           0;           0;          2;Terminales                                        ;SAM C3520                                         
2015-11-24;         48;Samsung                                           ;Smarthphones y Masivos;               27;           0;                 0;               0;          27;S.C.                ;S.C.                ;           0;           0;          2;Terminales                                        ;SAM E1205                                         
2015-11-24;         48;Samsung                                           ;Smarthphones y Masivos;                2;           0;                 0;               0;           2;S.C.                ;S.C.                ;           0;           0;          2;Terminales                                        ;SAM E2121                                         
2015-11-24;         48;Samsung                                           ;Smarthphones y Masivos;               16;           0;                 0;               0;          16;S.C.                ;S.C.                ;           0;           0;          2;Terminales                                        ;SAM E2230                                         
2015-11-24;         48;Samsung                                           ;Smarthphones y Masivos;                2;           0;                 0;               0;           2;S.C.                ;S.C.                ;           0;           0;          2;Terminales                                        ;SAM E3210                                         
2015-11-24;         48;Samsung                                           ;Smarthphones y Masivos;                2;           0;                 0;               0;           2;S.C.                ;S.C.                ;           0;           0;          2;Terminales                                        ;SAM E3300                                         
2015-11-24;         48;Samsung                                           ;Smarthphones y Masivos;              108;           0;                 0;               0;         108;S.C.                ;S.C.                ;           0;           0;          2;Terminales                                        ;SAM Gear S R750                                   
2015-11-24;         48;Samsung                                           ;Smarthphones y Masivos;              111;         175;                 1;             176;         287;S.C.                ;S.C.                ;           0;           0;          2;Terminales                                        ;SAM GLXY A5                                       
2015-11-24;         48;Samsung                                           ;Smarthphones y Masivos;              795;           0;                 0;               0;         795;S.C.                ;S.C.                ;           0;           0;          2;Terminales                                        ;SAM GLXY Ace 4                                    
2015-11-24;         48;Samsung                                           ;Smarthphones y Masivos;              383;         495;                 2;             497;         880;198,8               ;352,0               ;           1;           5;          2;Terminales                                        ;SAM GLXY Ace 4 Lite                               
2015-11-24;         48;Samsung                                           ;Smarthphones y Masivos;             2719;        3640;              1667;            5307;        8026;37,6                ;56,9                ;         130;         282;          2;Terminales                                        ;SAM GLXY Ace 4 Neo                                
2015-11-24;         48;Samsung                                           ;Smarthphones y Masivos;              274;         118;                 2;             120;         394;S.C.                ;S.C.                ;           0;           0;          2;Terminales                                        ;SAM GLXY Core 2                                   
2015-11-24;         48;Samsung                                           ;Smarthphones y Masivos;              265;        1793;                 0;            1793;        2058;896,5               ;1029,0              ;           4;           4;          2;Terminales                                        ;SAM GLXY Core Prime                               
2015-11-24;         48;Samsung                                           ;Smarthphones y Masivos;              663;        1529;                32;            1561;        2224;446,0               ;635,4               ;           3;           7;          2;Terminales                                        ;SAM GLXY Grand Prime LTE                          
2015-11-24;         48;Samsung                                           ;Smarthphones y Masivos;             1614;        7187;              1420;            8607;       10221;17,6                ;20,9                ;         455;         977;          2;Terminales                                        ;SAM GLXY J1                                       
2015-11-24;         48;Samsung                                           ;Smarthphones y Masivos;             6592;       10375;              3938;           14313;       20905;12,6                ;18,4                ;        1141;        2270;          2;Terminales                                        ;SAM GLXY J5                                       
2015-11-24;         48;Samsung                                           ;Smarthphones y Masivos;             2548;        2324;                46;            2370;        4918;38,2                ;79,3                ;          58;         124;          2;Terminales                                        ;SAM GLXY J7                                       
2015-11-24;         48;Samsung                                           ;Smarthphones y Masivos;                2;           4;                 1;               5;           7;S.C.                ;S.C.                ;           0;           0;          2;Terminales                                        ;SAM i8190                                         
2015-11-24;         48;Samsung                                           ;Smarthphones y Masivos;                3;           0;                 0;               0;           3;S.C.                ;S.C.                ;           0;           0;          2;Terminales                                        ;SAM I8260                                         
2015-11-24;         48;Samsung                                           ;Smarthphones y Masivos;               95;         125;                 4;             129;         224;86,0                ;149,3               ;           0;           3;          2;Terminales                                        ;SAM I8550                                         
2015-11-24;         48;Samsung                                           ;Smarthphones y Masivos;                1;           0;                 0;               0;           1;S.C.                ;S.C.                ;           0;           0;          2;Terminales                                        ;SAM i9070                                         
2015-11-24;         48;Samsung                                           ;Smarthphones y Masivos;              249;          22;                 1;              23;         272;S.C.                ;S.C.                ;           0;           0;          2;Terminales                                        ;SAM I9080                                         
2015-11-24;         48;Samsung                                           ;Smarthphones y Masivos;               32;          19;                 0;              19;          51;S.C.                ;S.C.                ;           0;           0;          2;Terminales                                        ;SAM I9300                                         
2015-11-24;         48;Samsung                                           ;Smarthphones y Masivos;                1;           3;                 0;               3;           4;S.C.                ;S.C.                ;           0;           0;          2;Terminales                                        ;SAM M3710                                         
2015-11-24;         48;Samsung                                           ;Smarthphones y Masivos;                0;           2;                 0;               2;           2;S.C.                ;S.C.                ;           0;           0;          2;Terminales                                        ;SAM S3770                                         
2015-11-24;         48;Samsung                                           ;Smarthphones y Masivos;                1;           0;                 0;               0;           1;S.C.                ;S.C.                ;           0;           0;          2;Terminales                                        ;SAM S5230                                         
2015-11-24;         48;Samsung                                           ;Smarthphones y Masivos;              307;         321;                 0;             321;         628;642,0               ;1256,0              ;          -1;           1;          2;Terminales                                        ;SAM S5310                                         
2015-11-24;         48;Samsung                                           ;Smarthphones y Masivos;                0;          14;                 1;              15;          15;S.C.                ;S.C.                ;           0;           0;          2;Terminales                                        ;SAM S5360                                         
2015-11-24;         48;Samsung                                           ;Smarthphones y Masivos;                7;           0;                 0;               0;           7;S.C.                ;S.C.                ;           0;           0;          2;Terminales                                        ;SAM S5560                                         
2015-11-24;         48;Samsung                                           ;Smarthphones y Masivos;                0;           1;                 0;               1;           1;S.C.                ;S.C.                ;           0;           0;          2;Terminales                                        ;SAM S5570                                         
2015-11-24;         48;Samsung                                           ;Smarthphones y Masivos;                3;           3;                 1;               4;           7;S.C.                ;S.C.                ;           0;           0;          2;Terminales                                        ;SAM S5830                                         
2015-11-24;         48;Samsung                                           ;Smarthphones y Masivos;               10;           0;                 0;               0;          10;S.C.                ;S.C.                ;           0;           0;          2;Terminales                                        ;SAM S6010                                         
2015-11-24;         48;Samsung                                           ;Smarthphones y Masivos;               55;          34;                 1;              35;          90;S.C.                ;S.C.                ;           0;           0;          2;Terminales                                        ;SAM S6310                                         
2015-11-24;         48;Samsung                                           ;Smarthphones y Masivos;                1;           0;                 0;               0;           1;S.C.                ;S.C.                ;           0;           0;          2;Terminales                                        ;SAM S6500                                         
2015-11-24;         48;Samsung                                           ;Smarthphones y Masivos;               71;          16;                 0;              16;          87;S.C.                ;S.C.                ;           0;           0;          2;Terminales                                        ;SAM S6810E                                        
2015-11-24;         48;Samsung                                           ;Smarthphones y Masivos;                4;          13;                 1;              14;          18;S.C.                ;S.C.                ;           0;           0;          2;Terminales                                        ;SAM S7500                                         
2015-11-24;         48;Samsung                                           ;Smarthphones y Masivos;               30;          16;                 1;              17;          47;S.C.                ;S.C.                ;           0;           0;          2;Terminales                                        ;SAM S7560                                         
2015-11-24;         48;Samsung                                           ;Smarthphones y Masivos;              197;          45;                 1;              46;         243;S.C.                ;S.C.                ;           0;           0;          2;Terminales                                        ;SAM S7580                                         
2015-11-25;         48;Samsung                                           ;iPhone y Premium      ;               37;          48;                 0;              48;          85;S.C.                ;S.C.                ;           0;           0;          3;Terminales                                        ;SAM GLXY Alpha                                    
2015-11-25;         48;Samsung                                           ;iPhone y Premium      ;               30;          43;                 1;              44;          74;132,0               ;222,0               ;           0;           1;          3;Terminales                                        ;SAM GLXY S4                                       
2015-11-25;         48;Samsung                                           ;iPhone y Premium      ;               57;         111;                 1;             112;         169;10,5                ;15,8                ;           3;          32;          3;Terminales                                        ;SAM GLXY S5                                       
2015-11-25;         48;Samsung                                           ;iPhone y Premium      ;              980;        1637;               144;            1781;        2761;25,1                ;38,9                ;          69;         213;          3;Terminales                                        ;SAM GLXY S6                                       
2015-11-25;         48;Samsung                                           ;iPhone y Premium      ;              577;        1349;                72;            1421;        1998;30,5                ;42,8                ;          39;         140;          3;Terminales                                        ;SAM GLXY S6 EDGE                                  
2015-11-25;         48;Samsung                                           ;iPhone y Premium      ;              394;         510;                57;             567;         961;15,8                ;26,7                ;          32;         108;          3;Terminales                                        ;SAM GLXY S6 EDGE PLUS                             
2015-11-25;         48;Samsung                                           ;iPhone y Premium      ;                0;           8;                 0;               8;           8;S.C.                ;S.C.                ;           0;           0;          3;Terminales                                        ;SAM I9100                                         
2015-11-25;         48;Samsung                                           ;iPhone y Premium      ;                9;          20;                 2;              22;          31;S.C.                ;S.C.                ;           0;           0;          3;Terminales                                        ;SAM I9195                                         
2015-11-25;         48;Samsung                                           ;iPhone y Premium      ;                0;           2;                 0;               2;           2;S.C.                ;S.C.                ;           0;           0;          3;Terminales                                        ;SAM I9250                                         
2015-11-25;         48;Samsung                                           ;iPhone y Premium      ;               10;          12;                 0;              12;          22;S.C.                ;S.C.                ;           0;           0;          3;Terminales                                        ;SAM Note 3 Neo                                    
2015-11-25;         48;Samsung                                           ;iPhone y Premium      ;              223;         185;                14;             199;         422;85,3                ;180,9               ;           2;           7;          3;Terminales                                        ;SAM Note IV                                       
2015-11-25;         48;Samsung                                           ;iPhone y Premium      ;                0;           2;                 0;               2;           2;S.C.                ;S.C.                ;           0;           0;          3;Terminales                                        ;SAM Note N7000                                    
2015-11-25;         48;Samsung                                           ;iPhone y Premium      ;                1;           3;                 1;               4;           5;S.C.                ;S.C.                ;           0;           0;          3;Terminales                                        ;SAM Note N9005                                    
2015-11-25;         48;Samsung                                           ;Smarthphones y Masivos;                1;           0;                 0;               0;           1;S.C.                ;S.C.                ;           0;           0;          3;Terminales                                        ;SAM C276                                          
2015-11-25;         48;Samsung                                           ;Smarthphones y Masivos;                1;           5;                 0;               5;           6;S.C.                ;S.C.                ;           0;           0;          3;Terminales                                        ;SAM C3300                                         
2015-11-25;         48;Samsung                                           ;Smarthphones y Masivos;                2;           3;                 0;               3;           5;S.C.                ;S.C.                ;           0;           0;          3;Terminales                                        ;SAM C3310                                         
2015-11-25;         48;Samsung                                           ;Smarthphones y Masivos;                1;           0;                 0;               0;           1;S.C.                ;S.C.                ;           0;           0;          3;Terminales                                        ;SAM C3510                                         
2015-11-25;         48;Samsung                                           ;Smarthphones y Masivos;                0;           3;                 0;               3;           3;S.C.                ;S.C.                ;           0;           0;          3;Terminales                                        ;SAM C3520                                         
2015-11-25;         48;Samsung                                           ;Smarthphones y Masivos;               27;           0;                 0;               0;          27;S.C.                ;S.C.                ;           0;           0;          3;Terminales                                        ;SAM E1205                                         
2015-11-25;         48;Samsung                                           ;Smarthphones y Masivos;                2;           0;                 0;               0;           2;S.C.                ;S.C.                ;           0;           0;          3;Terminales                                        ;SAM E2121                                         
2015-11-25;         48;Samsung                                           ;Smarthphones y Masivos;               16;           0;                 0;               0;          16;S.C.                ;S.C.                ;           0;           0;          3;Terminales                                        ;SAM E2230                                         
2015-11-25;         48;Samsung                                           ;Smarthphones y Masivos;                2;           0;                 0;               0;           2;S.C.                ;S.C.                ;           0;           0;          3;Terminales                                        ;SAM E3210                                         
2015-11-25;         48;Samsung                                           ;Smarthphones y Masivos;                2;           0;                 0;               0;           2;S.C.                ;S.C.                ;           0;           0;          3;Terminales                                        ;SAM E3300                                         
2015-11-25;         48;Samsung                                           ;Smarthphones y Masivos;              108;           0;                 0;               0;         108;S.C.                ;S.C.                ;           0;           0;          3;Terminales                                        ;SAM Gear S R750                                   
2015-11-25;         48;Samsung                                           ;Smarthphones y Masivos;              111;         174;                 1;             175;         286;525,0               ;858,0               ;           1;           1;          3;Terminales                                        ;SAM GLXY A5                                       
2015-11-25;         48;Samsung                                           ;Smarthphones y Masivos;              350;           0;                 0;               0;         350;S.C.                ;S.C.                ;           0;           0;          3;Terminales                                        ;SAM GLXY Ace 4                                    
2015-11-25;         48;Samsung                                           ;Smarthphones y Masivos;              383;         493;                 1;             494;         877;185,3               ;328,9               ;           3;           8;          3;Terminales                                        ;SAM GLXY Ace 4 Lite                               
2015-11-25;         48;Samsung                                           ;Smarthphones y Masivos;             2719;        3517;              1663;            5180;        7899;38,3                ;58,4                ;         124;         406;          3;Terminales                                        ;SAM GLXY Ace 4 Neo                                
2015-11-25;         48;Samsung                                           ;Smarthphones y Masivos;              274;         118;                 2;             120;         394;S.C.                ;S.C.                ;           0;           0;          3;Terminales                                        ;SAM GLXY Core 2                                   
2015-11-25;         48;Samsung                                           ;Smarthphones y Masivos;              265;        1730;                 2;            1732;        1997;371,1               ;427,9               ;          10;          14;          3;Terminales                                        ;SAM GLXY Core Prime                               
2015-11-25;         48;Samsung                                           ;Smarthphones y Masivos;              663;        1520;                31;            1551;        2214;221,6               ;316,3               ;          14;          21;          3;Terminales                                        ;SAM GLXY Grand Prime LTE                          
2015-11-25;         48;Samsung                                           ;Smarthphones y Masivos;              329;        7330;              2055;            9385;        9714;19,1                ;19,8                ;         498;        1475;          3;Terminales                                        ;SAM GLXY J1                                       
2015-11-25;         48;Samsung                                           ;Smarthphones y Masivos;             5142;       10878;              3982;           14860;       20002;13,5                ;18,2                ;        1028;        3298;          3;Terminales                                        ;SAM GLXY J5                                       
2015-11-25;         48;Samsung                                           ;Smarthphones y Masivos;             3162;        2206;               236;            2442;        5604;30,9                ;70,9                ;         113;         237;          3;Terminales                                        ;SAM GLXY J7                                       
2015-11-25;         48;Samsung                                           ;Smarthphones y Masivos;                2;           4;                 1;               5;           7;S.C.                ;S.C.                ;           0;           0;          3;Terminales                                        ;SAM i8190                                         
2015-11-25;         48;Samsung                                           ;Smarthphones y Masivos;                3;           0;                 0;               0;           3;S.C.                ;S.C.                ;           0;           0;          3;Terminales                                        ;SAM I8260                                         
2015-11-25;         48;Samsung                                           ;Smarthphones y Masivos;               95;         123;                 2;             125;         220;93,8                ;165,0               ;           1;           4;          3;Terminales                                        ;SAM I8550                                         
2015-11-25;         48;Samsung                                           ;Smarthphones y Masivos;                1;           0;                 0;               0;           1;S.C.                ;S.C.                ;           0;           0;          3;Terminales                                        ;SAM i9070                                         
2015-11-25;         48;Samsung                                           ;Smarthphones y Masivos;              249;          22;                 1;              23;         272;S.C.                ;S.C.                ;           0;           0;          3;Terminales                                        ;SAM I9080                                         
2015-11-25;         48;Samsung                                           ;Smarthphones y Masivos;               32;          19;                 0;              19;          51;S.C.                ;S.C.                ;           0;           0;          3;Terminales                                        ;SAM I9300                                         
2015-11-25;         48;Samsung                                           ;Smarthphones y Masivos;                1;           3;                 0;               3;           4;S.C.                ;S.C.                ;           0;           0;          3;Terminales                                        ;SAM M3710                                         
2015-11-25;         48;Samsung                                           ;Smarthphones y Masivos;                0;           2;                 0;               2;           2;S.C.                ;S.C.                ;           0;           0;          3;Terminales                                        ;SAM S3770                                         
2015-11-25;         48;Samsung                                           ;Smarthphones y Masivos;                1;           0;                 0;               0;           1;S.C.                ;S.C.                ;           0;           0;          3;Terminales                                        ;SAM S5230                                         
2015-11-25;         48;Samsung                                           ;Smarthphones y Masivos;              307;         318;                 0;             318;         625;238,5               ;468,8               ;           3;           4;          3;Terminales                                        ;SAM S5310                                         
2015-11-25;         48;Samsung                                           ;Smarthphones y Masivos;                0;          14;                 1;              15;          15;S.C.                ;S.C.                ;           0;           0;          3;Terminales                                        ;SAM S5360                                         
2015-11-25;         48;Samsung                                           ;Smarthphones y Masivos;                7;           0;                 0;               0;           7;S.C.                ;S.C.                ;           0;           0;          3;Terminales                                        ;SAM S5560                                         
2015-11-25;         48;Samsung                                           ;Smarthphones y Masivos;                0;           1;                 0;               1;           1;S.C.                ;S.C.                ;           0;           0;          3;Terminales                                        ;SAM S5570                                         
2015-11-25;         48;Samsung                                           ;Smarthphones y Masivos;                3;           3;                 1;               4;           7;S.C.                ;S.C.                ;           0;           0;          3;Terminales                                        ;SAM S5830                                         
2015-11-25;         48;Samsung                                           ;Smarthphones y Masivos;               10;           0;                 0;               0;          10;S.C.                ;S.C.                ;           0;           0;          3;Terminales                                        ;SAM S6010                                         
2015-11-25;         48;Samsung                                           ;Smarthphones y Masivos;               55;          35;                 0;              35;          90;S.C.                ;S.C.                ;           0;           0;          3;Terminales                                        ;SAM S6310                                         
2015-11-25;         48;Samsung                                           ;Smarthphones y Masivos;                1;           0;                 0;               0;           1;S.C.                ;S.C.                ;           0;           0;          3;Terminales                                        ;SAM S6500                                         
2015-11-25;         48;Samsung                                           ;Smarthphones y Masivos;               71;          16;                 0;              16;          87;S.C.                ;S.C.                ;           0;           0;          3;Terminales                                        ;SAM S6810E                                        
2015-11-25;         48;Samsung                                           ;Smarthphones y Masivos;                4;          13;                 1;              14;          18;S.C.                ;S.C.                ;           0;           0;          3;Terminales                                        ;SAM S7500                                         
2015-11-25;         48;Samsung                                           ;Smarthphones y Masivos;               30;          16;                 1;              17;          47;S.C.                ;S.C.                ;           0;           0;          3;Terminales                                        ;SAM S7560                                         
2015-11-25;         48;Samsung                                           ;Smarthphones y Masivos;              197;          45;                 1;              46;         243;S.C.                ;S.C.                ;           0;           0;          3;Terminales                                        ;SAM S7580                                         
2015-11-26;         48;Samsung                                           ;iPhone y Premium      ;               37;          48;                 0;              48;          85;S.C.                ;S.C.                ;           0;           0;          4;Terminales                                        ;SAM GLXY Alpha                                    
2015-11-26;         48;Samsung                                           ;iPhone y Premium      ;               30;          43;                 1;              44;          74;176,0               ;296,0               ;           0;           1;          4;Terminales                                        ;SAM GLXY S4                                       
2015-11-26;         48;Samsung                                           ;iPhone y Premium      ;               57;         109;                 1;             110;         167;13,3                ;20,2                ;           1;          33;          4;Terminales                                        ;SAM GLXY S5                                       
2015-11-26;         48;Samsung                                           ;iPhone y Premium      ;              947;        1563;               161;            1724;        2671;23,2                ;36,0                ;          84;         297;          4;Terminales                                        ;SAM GLXY S6                                       
2015-11-26;         48;Samsung                                           ;iPhone y Premium      ;              557;        1350;                53;            1403;        1960;31,0                ;43,3                ;          41;         181;          4;Terminales                                        ;SAM GLXY S6 EDGE                                  
2015-11-26;         48;Samsung                                           ;iPhone y Premium      ;              381;         497;                37;             534;         915;13,7                ;23,5                ;          48;         156;          4;Terminales                                        ;SAM GLXY S6 EDGE PLUS                             
2015-11-26;         48;Samsung                                           ;iPhone y Premium      ;                0;           8;                 0;               8;           8;S.C.                ;S.C.                ;           0;           0;          4;Terminales                                        ;SAM I9100                                         
2015-11-26;         48;Samsung                                           ;iPhone y Premium      ;                9;          20;                 2;              22;          31;S.C.                ;S.C.                ;           0;           0;          4;Terminales                                        ;SAM I9195                                         
2015-11-26;         48;Samsung                                           ;iPhone y Premium      ;                0;           2;                 0;               2;           2;S.C.                ;S.C.                ;           0;           0;          4;Terminales                                        ;SAM I9250                                         
2015-11-26;         48;Samsung                                           ;iPhone y Premium      ;               10;          12;                 0;              12;          22;S.C.                ;S.C.                ;           0;           0;          4;Terminales                                        ;SAM Note 3 Neo                                    
2015-11-26;         48;Samsung                                           ;iPhone y Premium      ;              219;         192;                10;             202;         421;101,0               ;210,5               ;           1;           8;          4;Terminales                                        ;SAM Note IV                                       
2015-11-26;         48;Samsung                                           ;iPhone y Premium      ;                0;           2;                 0;               2;           2;S.C.                ;S.C.                ;           0;           0;          4;Terminales                                        ;SAM Note N7000                                    
2015-11-26;         48;Samsung                                           ;iPhone y Premium      ;                1;           4;                 0;               4;           5;S.C.                ;S.C.                ;           0;           0;          4;Terminales                                        ;SAM Note N9005                                    
2015-11-26;         48;Samsung                                           ;Smarthphones y Masivos;                1;           0;                 0;               0;           1;S.C.                ;S.C.                ;           0;           0;          4;Terminales                                        ;SAM C276                                          
2015-11-26;         48;Samsung                                           ;Smarthphones y Masivos;                1;           5;                 0;               5;           6;S.C.                ;S.C.                ;           0;           0;          4;Terminales                                        ;SAM C3300                                         
2015-11-26;         48;Samsung                                           ;Smarthphones y Masivos;                2;           3;                 0;               3;           5;S.C.                ;S.C.                ;           0;           0;          4;Terminales                                        ;SAM C3310                                         
2015-11-26;         48;Samsung                                           ;Smarthphones y Masivos;                1;           0;                 0;               0;           1;S.C.                ;S.C.                ;           0;           0;          4;Terminales                                        ;SAM C3510                                         
2015-11-26;         48;Samsung                                           ;Smarthphones y Masivos;                0;           3;                 0;               3;           3;S.C.                ;S.C.                ;           0;           0;          4;Terminales                                        ;SAM C3520                                         
2015-11-26;         48;Samsung                                           ;Smarthphones y Masivos;               27;           0;                 0;               0;          27;S.C.                ;S.C.                ;           0;           0;          4;Terminales                                        ;SAM E1205                                         
2015-11-26;         48;Samsung                                           ;Smarthphones y Masivos;                2;           0;                 0;               0;           2;S.C.                ;S.C.                ;           0;           0;          4;Terminales                                        ;SAM E2121                                         
2015-11-26;         48;Samsung                                           ;Smarthphones y Masivos;               16;           0;                 0;               0;          16;S.C.                ;S.C.                ;           0;           0;          4;Terminales                                        ;SAM E2230                                         
2015-11-26;         48;Samsung                                           ;Smarthphones y Masivos;                2;           0;                 0;               0;           2;S.C.                ;S.C.                ;           0;           0;          4;Terminales                                        ;SAM E3210                                         
2015-11-26;         48;Samsung                                           ;Smarthphones y Masivos;                2;           0;                 0;               0;           2;S.C.                ;S.C.                ;           0;           0;          4;Terminales                                        ;SAM E3300                                         
2015-11-26;         48;Samsung                                           ;Smarthphones y Masivos;              108;           0;                 0;               0;         108;S.C.                ;S.C.                ;           0;           0;          4;Terminales                                        ;SAM Gear S R750                                   
2015-11-26;         48;Samsung                                           ;Smarthphones y Masivos;              111;         174;                 1;             175;         286;700,0               ;1144,0              ;           0;           1;          4;Terminales                                        ;SAM GLXY A5                                       
2015-11-26;         48;Samsung                                           ;Smarthphones y Masivos;              350;           0;                 0;               0;         350;S.C.                ;S.C.                ;           0;           0;          4;Terminales                                        ;SAM GLXY Ace 4                                    
2015-11-26;         48;Samsung                                           ;Smarthphones y Masivos;              383;         490;                 1;             491;         874;178,5               ;317,8               ;           3;          11;          4;Terminales                                        ;SAM GLXY Ace 4 Lite                               
2015-11-26;         48;Samsung                                           ;Smarthphones y Masivos;             2719;        3382;              1667;            5049;        7768;38,0                ;58,5                ;         125;         531;          4;Terminales                                        ;SAM GLXY Ace 4 Neo                                
2015-11-26;         48;Samsung                                           ;Smarthphones y Masivos;              274;         120;                 0;             120;         394;S.C.                ;S.C.                ;           0;           0;          4;Terminales                                        ;SAM GLXY Core 2                                   
2015-11-26;         48;Samsung                                           ;Smarthphones y Masivos;              265;        1719;                 0;            1719;        1984;254,7               ;293,9               ;          13;          27;          4;Terminales                                        ;SAM GLXY Core Prime                               
2015-11-26;         48;Samsung                                           ;Smarthphones y Masivos;              663;        1510;                29;            1539;        2202;192,4               ;275,3               ;          11;          32;          4;Terminales                                        ;SAM GLXY Grand Prime LTE                          
2015-11-26;         48;Samsung                                           ;Smarthphones y Masivos;              278;        7332;              1557;            8889;        9167;17,8                ;18,3                ;         528;        2003;          4;Terminales                                        ;SAM GLXY J1                                       
2015-11-26;         48;Samsung                                           ;Smarthphones y Masivos;             4540;       11510;              2971;           14481;       19021;13,6                ;17,8                ;         965;        4263;          4;Terminales                                        ;SAM GLXY J5                                       
2015-11-26;         48;Samsung                                           ;Smarthphones y Masivos;             3065;        2148;               215;            2363;        5428;30,3                ;69,6                ;          75;         312;          4;Terminales                                        ;SAM GLXY J7                                       
2015-11-26;         48;Samsung                                           ;Smarthphones y Masivos;                2;           4;                 1;               5;           7;S.C.                ;S.C.                ;           0;           0;          4;Terminales                                        ;SAM i8190                                         
2015-11-26;         48;Samsung                                           ;Smarthphones y Masivos;                3;           0;                 0;               0;           3;S.C.                ;S.C.                ;           0;           0;          4;Terminales                                        ;SAM I8260                                         
2015-11-26;         48;Samsung                                           ;Smarthphones y Masivos;               95;         125;                 0;             125;         220;83,3                ;146,7               ;           2;           6;          4;Terminales                                        ;SAM I8550                                         
2015-11-26;         48;Samsung                                           ;Smarthphones y Masivos;                1;           0;                 0;               0;           1;S.C.                ;S.C.                ;           0;           0;          4;Terminales                                        ;SAM i9070                                         
2015-11-26;         48;Samsung                                           ;Smarthphones y Masivos;              249;          22;                 1;              23;         272;S.C.                ;S.C.                ;           0;           0;          4;Terminales                                        ;SAM I9080                                         
2015-11-26;         48;Samsung                                           ;Smarthphones y Masivos;               32;          19;                 0;              19;          51;S.C.                ;S.C.                ;           0;           0;          4;Terminales                                        ;SAM I9300                                         
2015-11-26;         48;Samsung                                           ;Smarthphones y Masivos;                1;           3;                 0;               3;           4;S.C.                ;S.C.                ;           0;           0;          4;Terminales                                        ;SAM M3710                                         
2015-11-26;         48;Samsung                                           ;Smarthphones y Masivos;                0;           2;                 0;               2;           2;S.C.                ;S.C.                ;           0;           0;          4;Terminales                                        ;SAM S3770                                         
2015-11-26;         48;Samsung                                           ;Smarthphones y Masivos;                1;           0;                 0;               0;           1;S.C.                ;S.C.                ;           0;           0;          4;Terminales                                        ;SAM S5230                                         
2015-11-26;         48;Samsung                                           ;Smarthphones y Masivos;              307;         316;                 0;             316;         623;252,8               ;498,4               ;           1;           5;          4;Terminales                                        ;SAM S5310                                         
2015-11-26;         48;Samsung                                           ;Smarthphones y Masivos;                0;          14;                 1;              15;          15;S.C.                ;S.C.                ;           0;           0;          4;Terminales                                        ;SAM S5360                                         
2015-11-26;         48;Samsung                                           ;Smarthphones y Masivos;                7;           0;                 0;               0;           7;S.C.                ;S.C.                ;           0;           0;          4;Terminales                                        ;SAM S5560                                         
2015-11-26;         48;Samsung                                           ;Smarthphones y Masivos;                0;           1;                 0;               1;           1;S.C.                ;S.C.                ;           0;           0;          4;Terminales                                        ;SAM S5570                                         
2015-11-26;         48;Samsung                                           ;Smarthphones y Masivos;                3;           4;                 0;               4;           7;S.C.                ;S.C.                ;           0;           0;          4;Terminales                                        ;SAM S5830                                         
2015-11-26;         48;Samsung                                           ;Smarthphones y Masivos;               10;           0;                 0;               0;          10;S.C.                ;S.C.                ;           0;           0;          4;Terminales                                        ;SAM S6010                                         
2015-11-26;         48;Samsung                                           ;Smarthphones y Masivos;               55;          35;                 0;              35;          90;S.C.                ;S.C.                ;           0;           0;          4;Terminales                                        ;SAM S6310                                         
2015-11-26;         48;Samsung                                           ;Smarthphones y Masivos;                1;           0;                 0;               0;           1;S.C.                ;S.C.                ;           0;           0;          4;Terminales                                        ;SAM S6500                                         
2015-11-26;         48;Samsung                                           ;Smarthphones y Masivos;               71;          16;                 0;              16;          87;S.C.                ;S.C.                ;           0;           0;          4;Terminales                                        ;SAM S6810E                                        
2015-11-26;         48;Samsung                                           ;Smarthphones y Masivos;                4;          13;                 1;              14;          18;S.C.                ;S.C.                ;           0;           0;          4;Terminales                                        ;SAM S7500                                         
2015-11-26;         48;Samsung                                           ;Smarthphones y Masivos;               30;          16;                 1;              17;          47;S.C.                ;S.C.                ;           0;           0;          4;Terminales                                        ;SAM S7560                                         
2015-11-26;         48;Samsung                                           ;Smarthphones y Masivos;              197;          46;                 0;              46;         243;S.C.                ;S.C.                ;           0;           0;          4;Terminales                                        ;SAM S7580                                         
2015-11-27;         48;Samsung                                           ;iPhone y Premium      ;                0;           0;                 0;               0;           0;0,0                 ;0,0                 ;           0;           1;          5;Terminales                                        ;SAM GLXY S4                                       
2015-11-27;         48;Samsung                                           ;iPhone y Premium      ;                0;           0;                 0;               0;           0;0,0                 ;0,0                 ;           2;          35;          5;Terminales                                        ;SAM GLXY S5                                       
2015-11-27;         48;Samsung                                           ;iPhone y Premium      ;                0;           0;                 0;               0;           0;0,0                 ;0,0                 ;          73;         370;          5;Terminales                                        ;SAM GLXY S6                                       
2015-11-27;         48;Samsung                                           ;iPhone y Premium      ;                0;           0;                 0;               0;           0;0,0                 ;0,0                 ;          46;         227;          5;Terminales                                        ;SAM GLXY S6 EDGE                                  
2015-11-27;         48;Samsung                                           ;iPhone y Premium      ;                0;           0;                 0;               0;           0;0,0                 ;0,0                 ;          32;         188;          5;Terminales                                        ;SAM GLXY S6 EDGE PLUS                             
2015-11-27;         48;Samsung                                           ;iPhone y Premium      ;                0;           0;                 0;               0;           0;0,0                 ;0,0                 ;           4;          12;          5;Terminales                                        ;SAM Note IV                                       
2015-11-27;         48;Samsung                                           ;Smarthphones y Masivos;                0;           0;                 0;               0;           0;0,0                 ;0,0                 ;           0;           1;          5;Terminales                                        ;SAM GLXY A5                                       
2015-11-27;         48;Samsung                                           ;Smarthphones y Masivos;                0;           0;                 0;               0;           0;0,0                 ;0,0                 ;           2;          13;          5;Terminales                                        ;SAM GLXY Ace 4 Lite                               
2015-11-27;         48;Samsung                                           ;Smarthphones y Masivos;                0;           0;                 0;               0;           0;0,0                 ;0,0                 ;         190;         721;          5;Terminales                                        ;SAM GLXY Ace 4 Neo                                
2015-11-27;         48;Samsung                                           ;Smarthphones y Masivos;                0;           0;                 0;               0;           0;0,0                 ;0,0                 ;          14;          41;          5;Terminales                                        ;SAM GLXY Core Prime                               
2015-11-27;         48;Samsung                                           ;Smarthphones y Masivos;                0;           0;                 0;               0;           0;0,0                 ;0,0                 ;          15;          47;          5;Terminales                                        ;SAM GLXY Grand Prime LTE                          
2015-11-27;         48;Samsung                                           ;Smarthphones y Masivos;                0;           0;                 0;               0;           0;0,0                 ;0,0                 ;         504;        2507;          5;Terminales                                        ;SAM GLXY J1                                       
2015-11-27;         48;Samsung                                           ;Smarthphones y Masivos;                0;           0;                 0;               0;           0;0,0                 ;0,0                 ;        1127;        5390;          5;Terminales                                        ;SAM GLXY J5                                       
2015-11-27;         48;Samsung                                           ;Smarthphones y Masivos;                0;           0;                 0;               0;           0;0,0                 ;0,0                 ;          74;         386;          5;Terminales                                        ;SAM GLXY J7                                       
2015-11-27;         48;Samsung                                           ;Smarthphones y Masivos;                0;           0;                 0;               0;           0;0,0                 ;0,0                 ;           0;           6;          5;Terminales                                        ;SAM I8550                                         
2015-11-27;         48;Samsung                                           ;Smarthphones y Masivos;                0;           0;                 0;               0;           0;0,0                 ;0,0                 ;           6;          11;          5;Terminales                                        ;SAM S5310                                         
2015-11-28;         48;Samsung                                           ;iPhone y Premium      ;                0;           0;                 0;               0;           0;0,0                 ;0,0                 ;           0;           1;          6;Terminales                                        ;SAM GLXY S4                                       
2015-11-28;         48;Samsung                                           ;iPhone y Premium      ;                0;           0;                 0;               0;           0;0,0                 ;0,0                 ;           0;          35;          6;Terminales                                        ;SAM GLXY S5                                       
2015-11-28;         48;Samsung                                           ;iPhone y Premium      ;                0;           0;                 0;               0;           0;0,0                 ;0,0                 ;          11;         381;          6;Terminales                                        ;SAM GLXY S6                                       
2015-11-28;         48;Samsung                                           ;iPhone y Premium      ;                0;           0;                 0;               0;           0;0,0                 ;0,0                 ;          12;         239;          6;Terminales                                        ;SAM GLXY S6 EDGE                                  
2015-11-28;         48;Samsung                                           ;iPhone y Premium      ;                0;           0;                 0;               0;           0;0,0                 ;0,0                 ;           3;         191;          6;Terminales                                        ;SAM GLXY S6 EDGE PLUS                             
2015-11-28;         48;Samsung                                           ;iPhone y Premium      ;                0;           0;                 0;               0;           0;0,0                 ;0,0                 ;           0;          12;          6;Terminales                                        ;SAM Note IV                                       
2015-11-28;         48;Samsung                                           ;Smarthphones y Masivos;                0;           0;                 0;               0;           0;0,0                 ;0,0                 ;           1;           2;          6;Terminales                                        ;SAM GLXY A5                                       
2015-11-28;         48;Samsung                                           ;Smarthphones y Masivos;                0;           0;                 0;               0;           0;0,0                 ;0,0                 ;           0;          13;          6;Terminales                                        ;SAM GLXY Ace 4 Lite                               
2015-11-28;         48;Samsung                                           ;Smarthphones y Masivos;                0;           0;                 0;               0;           0;0,0                 ;0,0                 ;          12;         733;          6;Terminales                                        ;SAM GLXY Ace 4 Neo                                
2015-11-28;         48;Samsung                                           ;Smarthphones y Masivos;                0;           0;                 0;               0;           0;0,0                 ;0,0                 ;          13;          54;          6;Terminales                                        ;SAM GLXY Core Prime                               
2015-11-28;         48;Samsung                                           ;Smarthphones y Masivos;                0;           0;                 0;               0;           0;0,0                 ;0,0                 ;          10;          57;          6;Terminales                                        ;SAM GLXY Grand Prime LTE                          
2015-11-28;         48;Samsung                                           ;Smarthphones y Masivos;                0;           0;                 0;               0;           0;0,0                 ;0,0                 ;         129;        2636;          6;Terminales                                        ;SAM GLXY J1                                       
2015-11-28;         48;Samsung                                           ;Smarthphones y Masivos;                0;           0;                 0;               0;           0;0,0                 ;0,0                 ;         306;        5696;          6;Terminales                                        ;SAM GLXY J5                                       
2015-11-28;         48;Samsung                                           ;Smarthphones y Masivos;                0;           0;                 0;               0;           0;0,0                 ;0,0                 ;          22;         408;          6;Terminales                                        ;SAM GLXY J7                                       
2015-11-28;         48;Samsung                                           ;Smarthphones y Masivos;                0;           0;                 0;               0;           0;0,0                 ;0,0                 ;           0;           6;          6;Terminales                                        ;SAM I8550                                         
2015-11-28;         48;Samsung                                           ;Smarthphones y Masivos;                0;           0;                 0;               0;           0;0,0                 ;0,0                 ;           0;          11;          6;Terminales                                        ;SAM S5310                                         
2015-11-29;         48;Samsung                                           ;iPhone y Premium      ;               37;          48;                 0;              48;          85;S.C.                ;S.C.                ;           0;           0;          7;Terminales                                        ;SAM GLXY Alpha                                    
2015-11-29;         48;Samsung                                           ;iPhone y Premium      ;               30;          43;                 1;              44;          74;308,0               ;518,0               ;           0;           1;          7;Terminales                                        ;SAM GLXY S4                                       
2015-11-29;         48;Samsung                                           ;iPhone y Premium      ;               57;         108;                 1;             109;         166;21,8                ;33,2                ;           0;          35;          7;Terminales                                        ;SAM GLXY S5                                       
2015-11-29;         48;Samsung                                           ;iPhone y Premium      ;             1006;        1532;               125;            1657;        2663;30,1                ;48,4                ;           4;         385;          7;Terminales                                        ;SAM GLXY S6                                       
2015-11-29;         48;Samsung                                           ;iPhone y Premium      ;              438;        1287;                94;            1381;        1819;39,9                ;52,6                ;           3;         242;          7;Terminales                                        ;SAM GLXY S6 EDGE                                  
2015-11-29;         48;Samsung                                           ;iPhone y Premium      ;              334;         479;                65;             544;         878;19,9                ;32,2                ;           0;         191;          7;Terminales                                        ;SAM GLXY S6 EDGE PLUS                             
2015-11-29;         48;Samsung                                           ;iPhone y Premium      ;                0;           8;                 0;               8;           8;S.C.                ;S.C.                ;           0;           0;          7;Terminales                                        ;SAM I9100                                         
2015-11-29;         48;Samsung                                           ;iPhone y Premium      ;                9;          20;                 2;              22;          31;S.C.                ;S.C.                ;           0;           0;          7;Terminales                                        ;SAM I9195                                         
2015-11-29;         48;Samsung                                           ;iPhone y Premium      ;                0;           2;                 0;               2;           2;S.C.                ;S.C.                ;           0;           0;          7;Terminales                                        ;SAM I9250                                         
2015-11-29;         48;Samsung                                           ;iPhone y Premium      ;               10;          12;                 0;              12;          22;S.C.                ;S.C.                ;           0;           0;          7;Terminales                                        ;SAM Note 3 Neo                                    
2015-11-29;         48;Samsung                                           ;iPhone y Premium      ;              204;         195;                21;             216;         420;126,0               ;245,0               ;           0;          12;          7;Terminales                                        ;SAM Note IV                                       
2015-11-29;         48;Samsung                                           ;iPhone y Premium      ;                0;           2;                 0;               2;           2;S.C.                ;S.C.                ;           0;           0;          7;Terminales                                        ;SAM Note N7000                                    
2015-11-29;         48;Samsung                                           ;iPhone y Premium      ;                1;           4;                 0;               4;           5;S.C.                ;S.C.                ;           0;           0;          7;Terminales                                        ;SAM Note N9005                                    
2015-11-29;         48;Samsung                                           ;Smarthphones y Masivos;                1;           0;                 0;               0;           1;S.C.                ;S.C.                ;           0;           0;          7;Terminales                                        ;SAM C276                                          
2015-11-29;         48;Samsung                                           ;Smarthphones y Masivos;                1;           5;                 0;               5;           6;S.C.                ;S.C.                ;           0;           0;          7;Terminales                                        ;SAM C3300                                         
2015-11-29;         48;Samsung                                           ;Smarthphones y Masivos;                2;           3;                 0;               3;           5;S.C.                ;S.C.                ;           0;           0;          7;Terminales                                        ;SAM C3310                                         
2015-11-29;         48;Samsung                                           ;Smarthphones y Masivos;                1;           0;                 0;               0;           1;S.C.                ;S.C.                ;           0;           0;          7;Terminales                                        ;SAM C3510                                         
2015-11-29;         48;Samsung                                           ;Smarthphones y Masivos;                0;           3;                 0;               3;           3;S.C.                ;S.C.                ;           0;           0;          7;Terminales                                        ;SAM C3520                                         
2015-11-29;         48;Samsung                                           ;Smarthphones y Masivos;               27;           0;                 0;               0;          27;S.C.                ;S.C.                ;           0;           0;          7;Terminales                                        ;SAM E1205                                         
2015-11-29;         48;Samsung                                           ;Smarthphones y Masivos;                2;           0;                 0;               0;           2;S.C.                ;S.C.                ;           0;           0;          7;Terminales                                        ;SAM E2121                                         
2015-11-29;         48;Samsung                                           ;Smarthphones y Masivos;               16;           0;                 0;               0;          16;S.C.                ;S.C.                ;           0;           0;          7;Terminales                                        ;SAM E2230                                         
2015-11-29;         48;Samsung                                           ;Smarthphones y Masivos;                2;           0;                 0;               0;           2;S.C.                ;S.C.                ;           0;           0;          7;Terminales                                        ;SAM E3210                                         
2015-11-29;         48;Samsung                                           ;Smarthphones y Masivos;                2;           0;                 0;               0;           2;S.C.                ;S.C.                ;           0;           0;          7;Terminales                                        ;SAM E3300                                         
2015-11-29;         48;Samsung                                           ;Smarthphones y Masivos;              108;           0;                 0;               0;         108;S.C.                ;S.C.                ;           0;           0;          7;Terminales                                        ;SAM Gear S R750                                   
2015-11-29;         48;Samsung                                           ;Smarthphones y Masivos;              114;         173;                 1;             174;         288;609,0               ;1008,0              ;           0;           2;          7;Terminales                                        ;SAM GLXY A5                                       
2015-11-29;         48;Samsung                                           ;Smarthphones y Masivos;              350;           0;                 0;               0;         350;S.C.                ;S.C.                ;           0;           0;          7;Terminales                                        ;SAM GLXY Ace 4                                    
2015-11-29;         48;Samsung                                           ;Smarthphones y Masivos;              383;         488;                 1;             489;         872;244,5               ;436,0               ;           1;          14;          7;Terminales                                        ;SAM GLXY Ace 4 Lite                               
2015-11-29;         48;Samsung                                           ;Smarthphones y Masivos;             2126;        3173;              1758;            4931;        7057;46,9                ;67,1                ;           3;         736;          7;Terminales                                        ;SAM GLXY Ace 4 Neo                                
2015-11-29;         48;Samsung                                           ;Smarthphones y Masivos;              279;         120;                 0;             120;         399;S.C.                ;S.C.                ;           0;           0;          7;Terminales                                        ;SAM GLXY Core 2                                   
2015-11-29;         48;Samsung                                           ;Smarthphones y Masivos;              269;        1683;                 0;            1683;        1952;206,7               ;239,7               ;           3;          57;          7;Terminales                                        ;SAM GLXY Core Prime                               
2015-11-29;         48;Samsung                                           ;Smarthphones y Masivos;              664;        1473;                29;            1502;        2166;159,3               ;229,7               ;           9;          66;          7;Terminales                                        ;SAM GLXY Grand Prime LTE                          
2015-11-29;         48;Samsung                                           ;Smarthphones y Masivos;              288;        7253;               959;            8212;        8500;21,5                ;22,3                ;          37;        2673;          7;Terminales                                        ;SAM GLXY J1                                       
2015-11-29;         48;Samsung                                           ;Smarthphones y Masivos;             3918;       11195;              2385;           13580;       17498;16,4                ;21,2                ;          93;        5789;          7;Terminales                                        ;SAM GLXY J5                                       
2015-11-29;         48;Samsung                                           ;Smarthphones y Masivos;             2892;        2152;               279;            2431;        5323;40,9                ;89,6                ;           8;         416;          7;Terminales                                        ;SAM GLXY J7                                       
2015-11-29;         48;Samsung                                           ;Smarthphones y Masivos;                2;           4;                 1;               5;           7;S.C.                ;S.C.                ;           0;           0;          7;Terminales                                        ;SAM i8190                                         
2015-11-29;         48;Samsung                                           ;Smarthphones y Masivos;                3;           0;                 0;               0;           3;S.C.                ;S.C.                ;           0;           0;          7;Terminales                                        ;SAM I8260                                         
2015-11-29;         48;Samsung                                           ;Smarthphones y Masivos;               95;         124;                 0;             124;         219;144,7               ;255,5               ;           0;           6;          7;Terminales                                        ;SAM I8550                                         
2015-11-29;         48;Samsung                                           ;Smarthphones y Masivos;                1;           0;                 0;               0;           1;S.C.                ;S.C.                ;           0;           0;          7;Terminales                                        ;SAM i9070                                         
2015-11-29;         48;Samsung                                           ;Smarthphones y Masivos;              249;          22;                 1;              23;         272;S.C.                ;S.C.                ;           0;           0;          7;Terminales                                        ;SAM I9080                                         
2015-11-29;         48;Samsung                                           ;Smarthphones y Masivos;               32;          19;                 0;              19;          51;S.C.                ;S.C.                ;           0;           0;          7;Terminales                                        ;SAM I9300                                         
2015-11-29;         48;Samsung                                           ;Smarthphones y Masivos;                1;           3;                 0;               3;           4;S.C.                ;S.C.                ;           0;           0;          7;Terminales                                        ;SAM M3710                                         
2015-11-29;         48;Samsung                                           ;Smarthphones y Masivos;                0;           2;                 0;               2;           2;S.C.                ;S.C.                ;           0;           0;          7;Terminales                                        ;SAM S3770                                         
2015-11-29;         48;Samsung                                           ;Smarthphones y Masivos;                1;           0;                 0;               0;           1;S.C.                ;S.C.                ;           0;           0;          7;Terminales                                        ;SAM S5230                                         
2015-11-29;         48;Samsung                                           ;Smarthphones y Masivos;              307;         310;                 0;             310;         617;197,3               ;392,6               ;           0;          11;          7;Terminales                                        ;SAM S5310                                         
2015-11-29;         48;Samsung                                           ;Smarthphones y Masivos;                0;          14;                 1;              15;          15;S.C.                ;S.C.                ;           0;           0;          7;Terminales                                        ;SAM S5360                                         
2015-11-29;         48;Samsung                                           ;Smarthphones y Masivos;                7;           0;                 0;               0;           7;S.C.                ;S.C.                ;           0;           0;          7;Terminales                                        ;SAM S5560                                         
2015-11-29;         48;Samsung                                           ;Smarthphones y Masivos;                0;           1;                 0;               1;           1;S.C.                ;S.C.                ;           0;           0;          7;Terminales                                        ;SAM S5570                                         
2015-11-29;         48;Samsung                                           ;Smarthphones y Masivos;                3;           3;                 0;               3;           6;S.C.                ;S.C.                ;           0;           0;          7;Terminales                                        ;SAM S5830                                         
2015-11-29;         48;Samsung                                           ;Smarthphones y Masivos;               10;           0;                 0;               0;          10;S.C.                ;S.C.                ;           0;           0;          7;Terminales                                        ;SAM S6010                                         
2015-11-29;         48;Samsung                                           ;Smarthphones y Masivos;               55;          35;                 0;              35;          90;S.C.                ;S.C.                ;           0;           0;          7;Terminales                                        ;SAM S6310                                         
2015-11-29;         48;Samsung                                           ;Smarthphones y Masivos;                1;           0;                 0;               0;           1;S.C.                ;S.C.                ;           0;           0;          7;Terminales                                        ;SAM S6500                                         
2015-11-29;         48;Samsung                                           ;Smarthphones y Masivos;               71;          16;                 0;              16;          87;S.C.                ;S.C.                ;           0;           0;          7;Terminales                                        ;SAM S6810E                                        
2015-11-29;         48;Samsung                                           ;Smarthphones y Masivos;                4;          13;                 1;              14;          18;S.C.                ;S.C.                ;           0;           0;          7;Terminales                                        ;SAM S7500                                         
2015-11-29;         48;Samsung                                           ;Smarthphones y Masivos;               30;          16;                 1;              17;          47;S.C.                ;S.C.                ;           0;           0;          7;Terminales                                        ;SAM S7560                                         
2015-11-29;         48;Samsung                                           ;Smarthphones y Masivos;              197;          46;                 0;              46;         243;S.C.                ;S.C.                ;           0;           0;          7;Terminales                                        ;SAM S7580                                         
2015-11-30;         49;Samsung                                           ;iPhone y Premium      ;               37;          34;                 0;              34;          71;S.C.                ;S.C.                ;           0;           0;          1;Terminales                                        ;SAM GLXY Alpha                                    
2015-11-30;         49;Samsung                                           ;iPhone y Premium      ;               30;          39;                 1;              40;          70;S.C.                ;S.C.                ;           0;           0;          1;Terminales                                        ;SAM GLXY S4                                       
2015-11-30;         49;Samsung                                           ;iPhone y Premium      ;               57;          89;                 1;              90;         147;90,0                ;147,0               ;           1;           1;          1;Terminales                                        ;SAM GLXY S5                                       
2015-11-30;         49;Samsung                                           ;iPhone y Premium      ;              878;        1472;               247;            1719;        2597;26,4                ;40,0                ;          65;          65;          1;Terminales                                        ;SAM GLXY S6                                       
2015-11-30;         49;Samsung                                           ;iPhone y Premium      ;              387;        1283;               102;            1385;        1772;29,5                ;37,7                ;          47;          47;          1;Terminales                                        ;SAM GLXY S6 EDGE                                  
2015-11-30;         49;Samsung                                           ;iPhone y Premium      ;              303;         481;                59;             540;         843;15,9                ;24,8                ;          34;          34;          1;Terminales                                        ;SAM GLXY S6 EDGE PLUS                             
2015-11-30;         49;Samsung                                           ;iPhone y Premium      ;                0;           8;                 0;               8;           8;S.C.                ;S.C.                ;           0;           0;          1;Terminales                                        ;SAM I9100                                         
2015-11-30;         49;Samsung                                           ;iPhone y Premium      ;                9;          20;                 2;              22;          31;S.C.                ;S.C.                ;           0;           0;          1;Terminales                                        ;SAM I9195                                         
2015-11-30;         49;Samsung                                           ;iPhone y Premium      ;                0;           2;                 0;               2;           2;S.C.                ;S.C.                ;           0;           0;          1;Terminales                                        ;SAM I9250                                         
2015-11-30;         49;Samsung                                           ;iPhone y Premium      ;               10;          12;                 0;              12;          22;S.C.                ;S.C.                ;           0;           0;          1;Terminales                                        ;SAM Note 3 Neo                                    
2015-11-30;         49;Samsung                                           ;iPhone y Premium      ;              195;         202;                22;             224;         419;224,0               ;419,0               ;           1;           1;          1;Terminales                                        ;SAM Note IV                                       
2015-11-30;         49;Samsung                                           ;iPhone y Premium      ;                0;           2;                 0;               2;           2;S.C.                ;S.C.                ;           0;           0;          1;Terminales                                        ;SAM Note N7000                                    
2015-11-30;         49;Samsung                                           ;iPhone y Premium      ;                1;           4;                 0;               4;           5;S.C.                ;S.C.                ;           0;           0;          1;Terminales                                        ;SAM Note N9005                                    
2015-11-30;         49;Samsung                                           ;Smarthphones y Masivos;                1;           0;                 0;               0;           1;S.C.                ;S.C.                ;           0;           0;          1;Terminales                                        ;SAM C276                                          
2015-11-30;         49;Samsung                                           ;Smarthphones y Masivos;                1;           5;                 0;               5;           6;S.C.                ;S.C.                ;           0;           0;          1;Terminales                                        ;SAM C3300                                         
2015-11-30;         49;Samsung                                           ;Smarthphones y Masivos;                2;           3;                 0;               3;           5;S.C.                ;S.C.                ;           0;           0;          1;Terminales                                        ;SAM C3310                                         
2015-11-30;         49;Samsung                                           ;Smarthphones y Masivos;                1;           0;                 0;               0;           1;S.C.                ;S.C.                ;           0;           0;          1;Terminales                                        ;SAM C3510                                         
2015-11-30;         49;Samsung                                           ;Smarthphones y Masivos;                0;           3;                 0;               3;           3;S.C.                ;S.C.                ;           0;           0;          1;Terminales                                        ;SAM C3520                                         
2015-11-30;         49;Samsung                                           ;Smarthphones y Masivos;               27;           0;                 0;               0;          27;S.C.                ;S.C.                ;           0;           0;          1;Terminales                                        ;SAM E1205                                         
2015-11-30;         49;Samsung                                           ;Smarthphones y Masivos;                2;           0;                 0;               0;           2;S.C.                ;S.C.                ;           0;           0;          1;Terminales                                        ;SAM E2121                                         
2015-11-30;         49;Samsung                                           ;Smarthphones y Masivos;               16;           0;                 0;               0;          16;S.C.                ;S.C.                ;           0;           0;          1;Terminales                                        ;SAM E2230                                         
2015-11-30;         49;Samsung                                           ;Smarthphones y Masivos;                2;           0;                 0;               0;           2;S.C.                ;S.C.                ;           0;           0;          1;Terminales                                        ;SAM E3210                                         
2015-11-30;         49;Samsung                                           ;Smarthphones y Masivos;                2;           0;                 0;               0;           2;S.C.                ;S.C.                ;           0;           0;          1;Terminales                                        ;SAM E3300                                         
2015-11-30;         49;Samsung                                           ;Smarthphones y Masivos;              108;           0;                 0;               0;         108;S.C.                ;S.C.                ;           0;           0;          1;Terminales                                        ;SAM Gear S R750                                   
2015-11-30;         49;Samsung                                           ;Smarthphones y Masivos;              114;         163;                 1;             164;         278;S.C.                ;S.C.                ;           0;           0;          1;Terminales                                        ;SAM GLXY A5                                       
2015-11-30;         49;Samsung                                           ;Smarthphones y Masivos;              475;           0;                 0;               0;         475;S.C.                ;S.C.                ;           0;           0;          1;Terminales                                        ;SAM GLXY Ace 4                                    
2015-11-30;         49;Samsung                                           ;Smarthphones y Masivos;              383;         488;                 1;             489;         872;489,0               ;872,0               ;           1;           1;          1;Terminales                                        ;SAM GLXY Ace 4 Lite                               
2015-11-30;         49;Samsung                                           ;Smarthphones y Masivos;             2126;        3304;              1539;            4843;        6969;57,7                ;83,0                ;          84;          84;          1;Terminales                                        ;SAM GLXY Ace 4 Neo                                
2015-11-30;         49;Samsung                                           ;Smarthphones y Masivos;              279;         120;                 0;             120;         399;S.C.                ;S.C.                ;           0;           0;          1;Terminales                                        ;SAM GLXY Core 2                                   
2015-11-30;         49;Samsung                                           ;Smarthphones y Masivos;              269;        1669;                 0;            1669;        1938;128,4               ;149,1               ;          13;          13;          1;Terminales                                        ;SAM GLXY Core Prime                               
2015-11-30;         49;Samsung                                           ;Smarthphones y Masivos;              661;        1468;                29;            1497;        2158;149,7               ;215,8               ;          10;          10;          1;Terminales                                        ;SAM GLXY Grand Prime LTE                          
2015-11-30;         49;Samsung                                           ;Smarthphones y Masivos;             5563;        7105;               478;            7583;       13146;12,3                ;21,3                ;         618;         618;          1;Terminales                                        ;SAM GLXY J1                                       
2015-11-30;         49;Samsung                                           ;Smarthphones y Masivos;            20164;       10606;              2072;           12678;       32842;11,2                ;29,0                ;        1133;        1133;          1;Terminales                                        ;SAM GLXY J5                                       
2015-11-30;         49;Samsung                                           ;Smarthphones y Masivos;             2742;        2073;               400;            2473;        5215;23,1                ;48,7                ;         107;         107;          1;Terminales                                        ;SAM GLXY J7                                       
2015-11-30;         49;Samsung                                           ;Smarthphones y Masivos;                2;           4;                 1;               5;           7;S.C.                ;S.C.                ;           0;           0;          1;Terminales                                        ;SAM i8190                                         
2015-11-30;         49;Samsung                                           ;Smarthphones y Masivos;                3;           0;                 0;               0;           3;S.C.                ;S.C.                ;           0;           0;          1;Terminales                                        ;SAM I8260                                         
2015-11-30;         49;Samsung                                           ;Smarthphones y Masivos;               95;         124;                 0;             124;         219;62,0                ;109,5               ;           2;           2;          1;Terminales                                        ;SAM I8550                                         
2015-11-30;         49;Samsung                                           ;Smarthphones y Masivos;                1;           0;                 0;               0;           1;S.C.                ;S.C.                ;           0;           0;          1;Terminales                                        ;SAM i9070                                         
2015-11-30;         49;Samsung                                           ;Smarthphones y Masivos;              249;          22;                 1;              23;         272;S.C.                ;S.C.                ;           0;           0;          1;Terminales                                        ;SAM I9080                                         
2015-11-30;         49;Samsung                                           ;Smarthphones y Masivos;               32;          19;                 0;              19;          51;S.C.                ;S.C.                ;           0;           0;          1;Terminales                                        ;SAM I9300                                         
2015-11-30;         49;Samsung                                           ;Smarthphones y Masivos;                1;           3;                 0;               3;           4;S.C.                ;S.C.                ;           0;           0;          1;Terminales                                        ;SAM M3710                                         
2015-11-30;         49;Samsung                                           ;Smarthphones y Masivos;                0;           2;                 0;               2;           2;S.C.                ;S.C.                ;           0;           0;          1;Terminales                                        ;SAM S3770                                         
2015-11-30;         49;Samsung                                           ;Smarthphones y Masivos;                1;           0;                 0;               0;           1;S.C.                ;S.C.                ;           0;           0;          1;Terminales                                        ;SAM S5230                                         
2015-11-30;         49;Samsung                                           ;Smarthphones y Masivos;              307;         305;                 0;             305;         612;76,3                ;153,0               ;           4;           4;          1;Terminales                                        ;SAM S5310                                         
2015-11-30;         49;Samsung                                           ;Smarthphones y Masivos;                0;          14;                 1;              15;          15;S.C.                ;S.C.                ;           0;           0;          1;Terminales                                        ;SAM S5360                                         
2015-11-30;         49;Samsung                                           ;Smarthphones y Masivos;                7;           0;                 0;               0;           7;S.C.                ;S.C.                ;           0;           0;          1;Terminales                                        ;SAM S5560                                         
2015-11-30;         49;Samsung                                           ;Smarthphones y Masivos;                0;           1;                 0;               1;           1;S.C.                ;S.C.                ;           0;           0;          1;Terminales                                        ;SAM S5570                                         
2015-11-30;         49;Samsung                                           ;Smarthphones y Masivos;                3;           4;                 0;               4;           7;S.C.                ;S.C.                ;           0;           0;          1;Terminales                                        ;SAM S5830                                         
2015-11-30;         49;Samsung                                           ;Smarthphones y Masivos;               10;           0;                 0;               0;          10;S.C.                ;S.C.                ;           0;           0;          1;Terminales                                        ;SAM S6010                                         
2015-11-30;         49;Samsung                                           ;Smarthphones y Masivos;               55;          34;                 0;              34;          89;S.C.                ;S.C.                ;           0;           0;          1;Terminales                                        ;SAM S6310                                         
2015-11-30;         49;Samsung                                           ;Smarthphones y Masivos;                1;           0;                 0;               0;           1;S.C.                ;S.C.                ;           0;           0;          1;Terminales                                        ;SAM S6500                                         
2015-11-30;         49;Samsung                                           ;Smarthphones y Masivos;               71;          16;                 0;              16;          87;S.C.                ;S.C.                ;           0;           0;          1;Terminales                                        ;SAM S6810E                                        
2015-11-30;         49;Samsung                                           ;Smarthphones y Masivos;                4;          13;                 1;              14;          18;S.C.                ;S.C.                ;           0;           0;          1;Terminales                                        ;SAM S7500                                         
2015-11-30;         49;Samsung                                           ;Smarthphones y Masivos;               30;          16;                 1;              17;          47;S.C.                ;S.C.                ;           0;           0;          1;Terminales                                        ;SAM S7560                                         
2015-11-30;         49;Samsung                                           ;Smarthphones y Masivos;              197;          43;                 0;              43;         240;S.C.                ;S.C.                ;           0;           0;          1;Terminales                                        ;SAM S7580                                         
2015-11-16;         47;Sony Ericsson                                     ;iPhone y Premium      ;               11;          28;                 1;              29;          40;S.C.                ;S.C.                ;           0;           0;          1;Terminales                                        ;SON XP Z1                                         
2015-11-16;         47;Sony Ericsson                                     ;iPhone y Premium      ;               20;          12;                 1;              13;          33;S.C.                ;S.C.                ;           0;           0;          1;Terminales                                        ;SON XP Z3                                         
2015-11-16;         47;Sony Ericsson                                     ;iPhone y Premium      ;                0;           0;                 1;               1;           1;S.C.                ;S.C.                ;           0;           0;          1;Terminales                                        ;SON XP ZL                                         
2015-11-16;         47;Sony Ericsson                                     ;Smarthphones y Masivos;                1;           0;                 0;               0;           1;S.C.                ;S.C.                ;           0;           0;          1;Terminales                                        ;SON K200                                          
2015-11-16;         47;Sony Ericsson                                     ;Smarthphones y Masivos;                0;           1;                 0;               1;           1;S.C.                ;S.C.                ;           0;           0;          1;Terminales                                        ;SON Mugua                                         
2015-11-16;         47;Sony Ericsson                                     ;Smarthphones y Masivos;                0;           1;                 0;               1;           1;S.C.                ;S.C.                ;           0;           0;          1;Terminales                                        ;SON TXT PRO                                       
2015-11-16;         47;Sony Ericsson                                     ;Smarthphones y Masivos;                1;           0;                 0;               0;           1;S.C.                ;S.C.                ;           0;           0;          1;Terminales                                        ;SON W150                                          
2015-11-16;         47;Sony Ericsson                                     ;Smarthphones y Masivos;                1;           0;                 0;               0;           1;S.C.                ;S.C.                ;           0;           0;          1;Terminales                                        ;SON W580                                          
2015-11-16;         47;Sony Ericsson                                     ;Smarthphones y Masivos;                1;           0;                 0;               0;           1;S.C.                ;S.C.                ;           0;           0;          1;Terminales                                        ;SON X10 Mini Pro                                  
2015-11-16;         47;Sony Ericsson                                     ;Smarthphones y Masivos;                0;           1;                 0;               1;           1;S.C.                ;S.C.                ;           0;           0;          1;Terminales                                        ;SON X8                                            
2015-11-16;         47;Sony Ericsson                                     ;Smarthphones y Masivos;              702;        1185;                16;            1201;        1903;46,2                ;73,2                ;          26;          26;          1;Terminales                                        ;SON XP C3                                         
2015-11-16;         47;Sony Ericsson                                     ;Smarthphones y Masivos;                6;          60;                 0;              60;          66;S.C.                ;S.C.                ;           0;           0;          1;Terminales                                        ;SON XP E                                          
2015-11-16;         47;Sony Ericsson                                     ;Smarthphones y Masivos;              478;         733;                 2;             735;        1213;735,0               ;1213,0              ;           1;           1;          1;Terminales                                        ;SON XP E1                                         
2015-11-16;         47;Sony Ericsson                                     ;Smarthphones y Masivos;             1396;          15;                 0;              15;        1411;S.C.                ;S.C.                ;           0;           0;          1;Terminales                                        ;SON XP E4                                         
2015-11-16;         47;Sony Ericsson                                     ;Smarthphones y Masivos;             8573;        2419;                60;            2479;       11052;80,0                ;356,5               ;          31;          31;          1;Terminales                                        ;SON XP E4G                                        
2015-11-16;         47;Sony Ericsson                                     ;Smarthphones y Masivos;               28;          82;                 2;              84;         112;84,0                ;112,0               ;           1;           1;          1;Terminales                                        ;SON XP L                                          
2015-11-16;         47;Sony Ericsson                                     ;Smarthphones y Masivos;               47;         200;                 0;             200;         247;100,0               ;123,5               ;           2;           2;          1;Terminales                                        ;SON XP M2                                         
2015-11-16;         47;Sony Ericsson                                     ;Smarthphones y Masivos;             8287;         594;                 0;             594;        8881;39,6                ;592,1               ;          15;          15;          1;Terminales                                        ;SON XP M4                                         
2015-11-16;         47;Sony Ericsson                                     ;Smarthphones y Masivos;                0;           1;                 0;               1;           1;S.C.                ;S.C.                ;           0;           0;          1;Terminales                                        ;SON XP Pro                                        
2015-11-16;         47;Sony Ericsson                                     ;Smarthphones y Masivos;                0;           6;                 0;               6;           6;S.C.                ;S.C.                ;           0;           0;          1;Terminales                                        ;SON XP U                                          
2015-11-16;         47;Sony Ericsson                                     ;Smarthphones y Masivos;              123;          39;                 1;              40;         163;40,0                ;163,0               ;           1;           1;          1;Terminales                                        ;SON XP ZR                                         
2015-11-17;         47;Sony Ericsson                                     ;iPhone y Premium      ;               11;          28;                 1;              29;          40;S.C.                ;S.C.                ;           0;           0;          2;Terminales                                        ;SON XP Z1                                         
2015-11-17;         47;Sony Ericsson                                     ;iPhone y Premium      ;               20;          12;                 1;              13;          33;S.C.                ;S.C.                ;           0;           0;          2;Terminales                                        ;SON XP Z3                                         
2015-11-17;         47;Sony Ericsson                                     ;iPhone y Premium      ;                0;           0;                 1;               1;           1;S.C.                ;S.C.                ;           0;           0;          2;Terminales                                        ;SON XP ZL                                         
2015-11-17;         47;Sony Ericsson                                     ;Smarthphones y Masivos;                1;           0;                 0;               0;           1;S.C.                ;S.C.                ;           0;           0;          2;Terminales                                        ;SON K200                                          
2015-11-17;         47;Sony Ericsson                                     ;Smarthphones y Masivos;                0;           1;                 0;               1;           1;S.C.                ;S.C.                ;           0;           0;          2;Terminales                                        ;SON Mugua                                         
2015-11-17;         47;Sony Ericsson                                     ;Smarthphones y Masivos;                0;           1;                 0;               1;           1;S.C.                ;S.C.                ;           0;           0;          2;Terminales                                        ;SON TXT PRO                                       
2015-11-17;         47;Sony Ericsson                                     ;Smarthphones y Masivos;                1;           0;                 0;               0;           1;S.C.                ;S.C.                ;           0;           0;          2;Terminales                                        ;SON W150                                          
2015-11-17;         47;Sony Ericsson                                     ;Smarthphones y Masivos;                1;           0;                 0;               0;           1;S.C.                ;S.C.                ;           0;           0;          2;Terminales                                        ;SON W580                                          
2015-11-17;         47;Sony Ericsson                                     ;Smarthphones y Masivos;                1;           0;                 0;               0;           1;S.C.                ;S.C.                ;           0;           0;          2;Terminales                                        ;SON X10 Mini Pro                                  
2015-11-17;         47;Sony Ericsson                                     ;Smarthphones y Masivos;                0;           1;                 0;               1;           1;S.C.                ;S.C.                ;           0;           0;          2;Terminales                                        ;SON X8                                            
2015-11-17;         47;Sony Ericsson                                     ;Smarthphones y Masivos;              702;        1174;                17;            1191;        1893;68,1                ;108,2               ;           9;          35;          2;Terminales                                        ;SON XP C3                                         
2015-11-17;         47;Sony Ericsson                                     ;Smarthphones y Masivos;                6;          60;                 0;              60;          66;S.C.                ;S.C.                ;           0;           0;          2;Terminales                                        ;SON XP E                                          
2015-11-17;         47;Sony Ericsson                                     ;Smarthphones y Masivos;              478;         715;                 1;             716;        1194;477,3               ;796,0               ;           2;           3;          2;Terminales                                        ;SON XP E1                                         
2015-11-17;         47;Sony Ericsson                                     ;Smarthphones y Masivos;             1396;          15;                 0;              15;        1411;S.C.                ;S.C.                ;           0;           0;          2;Terminales                                        ;SON XP E4                                         
2015-11-17;         47;Sony Ericsson                                     ;Smarthphones y Masivos;             8558;        2398;                41;            2439;       10997;65,9                ;297,2               ;          43;          74;          2;Terminales                                        ;SON XP E4G                                        
2015-11-17;         47;Sony Ericsson                                     ;Smarthphones y Masivos;               28;          82;                 2;              84;         112;168,0               ;224,0               ;           0;           1;          2;Terminales                                        ;SON XP L                                          
2015-11-17;         47;Sony Ericsson                                     ;Smarthphones y Masivos;               47;         199;                 0;             199;         246;199,0               ;246,0               ;           0;           2;          2;Terminales                                        ;SON XP M2                                         
2015-11-17;         47;Sony Ericsson                                     ;Smarthphones y Masivos;             8187;         586;                 0;             586;        8773;51,0                ;762,9               ;           8;          23;          2;Terminales                                        ;SON XP M4                                         
2015-11-17;         47;Sony Ericsson                                     ;Smarthphones y Masivos;                0;           1;                 0;               1;           1;S.C.                ;S.C.                ;           0;           0;          2;Terminales                                        ;SON XP Pro                                        
2015-11-17;         47;Sony Ericsson                                     ;Smarthphones y Masivos;                0;           6;                 0;               6;           6;S.C.                ;S.C.                ;           0;           0;          2;Terminales                                        ;SON XP U                                          
2015-11-17;         47;Sony Ericsson                                     ;Smarthphones y Masivos;              123;          39;                 1;              40;         163;80,0                ;326,0               ;           0;           1;          2;Terminales                                        ;SON XP ZR                                         
2015-11-18;         47;Sony Ericsson                                     ;iPhone y Premium      ;               19;          28;                 1;              29;          48;S.C.                ;S.C.                ;           0;           0;          3;Terminales                                        ;SON XP Z1                                         
2015-11-18;         47;Sony Ericsson                                     ;iPhone y Premium      ;               25;          12;                 1;              13;          38;S.C.                ;S.C.                ;           0;           0;          3;Terminales                                        ;SON XP Z3                                         
2015-11-18;         47;Sony Ericsson                                     ;iPhone y Premium      ;                0;           0;                 1;               1;           1;S.C.                ;S.C.                ;           0;           0;          3;Terminales                                        ;SON XP ZL                                         
2015-11-18;         47;Sony Ericsson                                     ;Smarthphones y Masivos;                1;           0;                 0;               0;           1;S.C.                ;S.C.                ;           0;           0;          3;Terminales                                        ;SON K200                                          
2015-11-18;         47;Sony Ericsson                                     ;Smarthphones y Masivos;                0;           1;                 0;               1;           1;S.C.                ;S.C.                ;           0;           0;          3;Terminales                                        ;SON Mugua                                         
2015-11-18;         47;Sony Ericsson                                     ;Smarthphones y Masivos;                0;           1;                 0;               1;           1;S.C.                ;S.C.                ;           0;           0;          3;Terminales                                        ;SON TXT PRO                                       
2015-11-18;         47;Sony Ericsson                                     ;Smarthphones y Masivos;                1;           0;                 0;               0;           1;S.C.                ;S.C.                ;           0;           0;          3;Terminales                                        ;SON W150                                          
2015-11-18;         47;Sony Ericsson                                     ;Smarthphones y Masivos;                1;           0;                 0;               0;           1;S.C.                ;S.C.                ;           0;           0;          3;Terminales                                        ;SON W580                                          
2015-11-18;         47;Sony Ericsson                                     ;Smarthphones y Masivos;                1;           0;                 0;               0;           1;S.C.                ;S.C.                ;           0;           0;          3;Terminales                                        ;SON X10 Mini Pro                                  
2015-11-18;         47;Sony Ericsson                                     ;Smarthphones y Masivos;                0;           1;                 0;               1;           1;S.C.                ;S.C.                ;           0;           0;          3;Terminales                                        ;SON X8                                            
2015-11-18;         47;Sony Ericsson                                     ;Smarthphones y Masivos;              703;        1166;                17;            1183;        1886;68,3                ;108,8               ;          17;          52;          3;Terminales                                        ;SON XP C3                                         
2015-11-18;         47;Sony Ericsson                                     ;Smarthphones y Masivos;                6;          60;                 0;              60;          66;S.C.                ;S.C.                ;           0;           0;          3;Terminales                                        ;SON XP E                                          
2015-11-18;         47;Sony Ericsson                                     ;Smarthphones y Masivos;              495;         715;                 1;             716;        1211;716,0               ;1211,0              ;           0;           3;          3;Terminales                                        ;SON XP E1                                         
2015-11-18;         47;Sony Ericsson                                     ;Smarthphones y Masivos;             1396;          15;                 0;              15;        1411;45,0                ;4233,0              ;           1;           1;          3;Terminales                                        ;SON XP E4                                         
2015-11-18;         47;Sony Ericsson                                     ;Smarthphones y Masivos;             8603;        2285;                48;            2333;       10936;35,7                ;167,4               ;         122;         196;          3;Terminales                                        ;SON XP E4G                                        
2015-11-18;         47;Sony Ericsson                                     ;Smarthphones y Masivos;               35;          80;                 2;              82;         117;246,0               ;351,0               ;           0;           1;          3;Terminales                                        ;SON XP L                                          
2015-11-18;         47;Sony Ericsson                                     ;Smarthphones y Masivos;               56;         194;                 0;             194;         250;83,1                ;107,1               ;           5;           7;          3;Terminales                                        ;SON XP M2                                         
2015-11-18;         47;Sony Ericsson                                     ;Smarthphones y Masivos;             8195;         569;                 0;             569;        8764;44,9                ;691,9               ;          15;          38;          3;Terminales                                        ;SON XP M4                                         
2015-11-18;         47;Sony Ericsson                                     ;Smarthphones y Masivos;                0;           1;                 0;               1;           1;S.C.                ;S.C.                ;           0;           0;          3;Terminales                                        ;SON XP Pro                                        
2015-11-18;         47;Sony Ericsson                                     ;Smarthphones y Masivos;                0;           6;                 0;               6;           6;S.C.                ;S.C.                ;           0;           0;          3;Terminales                                        ;SON XP U                                          
2015-11-18;         47;Sony Ericsson                                     ;Smarthphones y Masivos;              194;          37;                 1;              38;         232;38,0                ;232,0               ;           2;           3;          3;Terminales                                        ;SON XP ZR                                         
2015-11-19;         47;Sony Ericsson                                     ;iPhone y Premium      ;               19;          28;                 1;              29;          48;S.C.                ;S.C.                ;           0;           0;          4;Terminales                                        ;SON XP Z1                                         
2015-11-19;         47;Sony Ericsson                                     ;iPhone y Premium      ;               25;          12;                 1;              13;          38;S.C.                ;S.C.                ;           0;           0;          4;Terminales                                        ;SON XP Z3                                         
2015-11-19;         47;Sony Ericsson                                     ;iPhone y Premium      ;                0;           0;                 1;               1;           1;S.C.                ;S.C.                ;           0;           0;          4;Terminales                                        ;SON XP ZL                                         
2015-11-19;         47;Sony Ericsson                                     ;Smarthphones y Masivos;                1;           0;                 0;               0;           1;S.C.                ;S.C.                ;           0;           0;          4;Terminales                                        ;SON K200                                          
2015-11-19;         47;Sony Ericsson                                     ;Smarthphones y Masivos;                0;           1;                 0;               1;           1;S.C.                ;S.C.                ;           0;           0;          4;Terminales                                        ;SON Mugua                                         
2015-11-19;         47;Sony Ericsson                                     ;Smarthphones y Masivos;                0;           1;                 0;               1;           1;S.C.                ;S.C.                ;           0;           0;          4;Terminales                                        ;SON TXT PRO                                       
2015-11-19;         47;Sony Ericsson                                     ;Smarthphones y Masivos;                1;           0;                 0;               0;           1;S.C.                ;S.C.                ;           0;           0;          4;Terminales                                        ;SON W150                                          
2015-11-19;         47;Sony Ericsson                                     ;Smarthphones y Masivos;                1;           0;                 0;               0;           1;S.C.                ;S.C.                ;           0;           0;          4;Terminales                                        ;SON W580                                          
2015-11-19;         47;Sony Ericsson                                     ;Smarthphones y Masivos;                1;           0;                 0;               0;           1;S.C.                ;S.C.                ;           0;           0;          4;Terminales                                        ;SON X10 Mini Pro                                  
2015-11-19;         47;Sony Ericsson                                     ;Smarthphones y Masivos;                0;           1;                 0;               1;           1;S.C.                ;S.C.                ;           0;           0;          4;Terminales                                        ;SON X8                                            
2015-11-19;         47;Sony Ericsson                                     ;Smarthphones y Masivos;              703;        1157;                17;            1174;        1877;69,1                ;110,4               ;          16;          68;          4;Terminales                                        ;SON XP C3                                         
2015-11-19;         47;Sony Ericsson                                     ;Smarthphones y Masivos;                6;          60;                 0;              60;          66;S.C.                ;S.C.                ;           0;           0;          4;Terminales                                        ;SON XP E                                          
2015-11-19;         47;Sony Ericsson                                     ;Smarthphones y Masivos;              495;         715;                 1;             716;        1211;954,7               ;1614,7              ;           0;           3;          4;Terminales                                        ;SON XP E1                                         
2015-11-19;         47;Sony Ericsson                                     ;Smarthphones y Masivos;             1396;          15;                 0;              15;        1411;60,0                ;5644,0              ;           0;           1;          4;Terminales                                        ;SON XP E4                                         
2015-11-19;         47;Sony Ericsson                                     ;Smarthphones y Masivos;             8590;        2260;                55;            2315;       10905;44,3                ;208,7               ;          13;         209;          4;Terminales                                        ;SON XP E4G                                        
2015-11-19;         47;Sony Ericsson                                     ;Smarthphones y Masivos;               35;          80;                 2;              82;         117;328,0               ;468,0               ;           0;           1;          4;Terminales                                        ;SON XP L                                          
2015-11-19;         47;Sony Ericsson                                     ;Smarthphones y Masivos;               56;         189;                 0;             189;         245;63,0                ;81,7                ;           5;          12;          4;Terminales                                        ;SON XP M2                                         
2015-11-19;         47;Sony Ericsson                                     ;Smarthphones y Masivos;             8314;         556;               163;             719;        9033;61,2                ;768,8               ;           9;          47;          4;Terminales                                        ;SON XP M4                                         
2015-11-19;         47;Sony Ericsson                                     ;Smarthphones y Masivos;                0;           1;                 0;               1;           1;S.C.                ;S.C.                ;           0;           0;          4;Terminales                                        ;SON XP Pro                                        
2015-11-19;         47;Sony Ericsson                                     ;Smarthphones y Masivos;                0;           6;                 0;               6;           6;S.C.                ;S.C.                ;           0;           0;          4;Terminales                                        ;SON XP U                                          
2015-11-19;         47;Sony Ericsson                                     ;Smarthphones y Masivos;              194;          36;                 1;              37;         231;37,0                ;231,0               ;           1;           4;          4;Terminales                                        ;SON XP ZR                                         
2015-11-20;         47;Sony Ericsson                                     ;Smarthphones y Masivos;                0;           0;                 0;               0;           0;0,0                 ;0,0                 ;          29;          97;          5;Terminales                                        ;SON XP C3                                         
2015-11-20;         47;Sony Ericsson                                     ;Smarthphones y Masivos;                0;           0;                 0;               0;           0;0,0                 ;0,0                 ;           0;           3;          5;Terminales                                        ;SON XP E1                                         
2015-11-20;         47;Sony Ericsson                                     ;Smarthphones y Masivos;                0;           0;                 0;               0;           0;0,0                 ;0,0                 ;           1;           2;          5;Terminales                                        ;SON XP E4                                         
2015-11-20;         47;Sony Ericsson                                     ;Smarthphones y Masivos;                0;           0;                 0;               0;           0;0,0                 ;0,0                 ;          17;         226;          5;Terminales                                        ;SON XP E4G                                        
2015-11-20;         47;Sony Ericsson                                     ;Smarthphones y Masivos;                0;           0;                 0;               0;           0;0,0                 ;0,0                 ;           0;           1;          5;Terminales                                        ;SON XP L                                          
2015-11-20;         47;Sony Ericsson                                     ;Smarthphones y Masivos;                0;           0;                 0;               0;           0;0,0                 ;0,0                 ;           8;          20;          5;Terminales                                        ;SON XP M2                                         
2015-11-20;         47;Sony Ericsson                                     ;Smarthphones y Masivos;                0;           0;                 0;               0;           0;0,0                 ;0,0                 ;          10;          57;          5;Terminales                                        ;SON XP M4                                         
2015-11-20;         47;Sony Ericsson                                     ;Smarthphones y Masivos;                0;           0;                 0;               0;           0;0,0                 ;0,0                 ;           1;           5;          5;Terminales                                        ;SON XP ZR                                         
2015-11-21;         47;Sony Ericsson                                     ;Smarthphones y Masivos;                0;           0;                 0;               0;           0;0,0                 ;0,0                 ;          22;         119;          6;Terminales                                        ;SON XP C3                                         
2015-11-21;         47;Sony Ericsson                                     ;Smarthphones y Masivos;                0;           0;                 0;               0;           0;0,0                 ;0,0                 ;           0;           3;          6;Terminales                                        ;SON XP E1                                         
2015-11-21;         47;Sony Ericsson                                     ;Smarthphones y Masivos;                0;           0;                 0;               0;           0;0,0                 ;0,0                 ;           0;           2;          6;Terminales                                        ;SON XP E4                                         
2015-11-21;         47;Sony Ericsson                                     ;Smarthphones y Masivos;                0;           0;                 0;               0;           0;0,0                 ;0,0                 ;           2;         228;          6;Terminales                                        ;SON XP E4G                                        
2015-11-21;         47;Sony Ericsson                                     ;Smarthphones y Masivos;                0;           0;                 0;               0;           0;0,0                 ;0,0                 ;           0;           1;          6;Terminales                                        ;SON XP L                                          
2015-11-21;         47;Sony Ericsson                                     ;Smarthphones y Masivos;                0;           0;                 0;               0;           0;0,0                 ;0,0                 ;           0;          20;          6;Terminales                                        ;SON XP M2                                         
2015-11-21;         47;Sony Ericsson                                     ;Smarthphones y Masivos;                0;           0;                 0;               0;           0;0,0                 ;0,0                 ;           5;          62;          6;Terminales                                        ;SON XP M4                                         
2015-11-21;         47;Sony Ericsson                                     ;Smarthphones y Masivos;                0;           0;                 0;               0;           0;0,0                 ;0,0                 ;           0;           5;          6;Terminales                                        ;SON XP ZR                                         
2015-11-22;         47;Sony Ericsson                                     ;iPhone y Premium      ;               19;          28;                 1;              29;          48;S.C.                ;S.C.                ;           0;           0;          7;Terminales                                        ;SON XP Z1                                         
2015-11-22;         47;Sony Ericsson                                     ;iPhone y Premium      ;               25;          12;                 1;              13;          38;S.C.                ;S.C.                ;           0;           0;          7;Terminales                                        ;SON XP Z3                                         
2015-11-22;         47;Sony Ericsson                                     ;iPhone y Premium      ;                0;           0;                 1;               1;           1;S.C.                ;S.C.                ;           0;           0;          7;Terminales                                        ;SON XP ZL                                         
2015-11-22;         47;Sony Ericsson                                     ;Smarthphones y Masivos;                1;           0;                 0;               0;           1;S.C.                ;S.C.                ;           0;           0;          7;Terminales                                        ;SON K200                                          
2015-11-22;         47;Sony Ericsson                                     ;Smarthphones y Masivos;                0;           1;                 0;               1;           1;S.C.                ;S.C.                ;           0;           0;          7;Terminales                                        ;SON Mugua                                         
2015-11-22;         47;Sony Ericsson                                     ;Smarthphones y Masivos;                0;           1;                 0;               1;           1;S.C.                ;S.C.                ;           0;           0;          7;Terminales                                        ;SON TXT PRO                                       
2015-11-22;         47;Sony Ericsson                                     ;Smarthphones y Masivos;                1;           0;                 0;               0;           1;S.C.                ;S.C.                ;           0;           0;          7;Terminales                                        ;SON W150                                          
2015-11-22;         47;Sony Ericsson                                     ;Smarthphones y Masivos;                1;           0;                 0;               0;           1;S.C.                ;S.C.                ;           0;           0;          7;Terminales                                        ;SON W580                                          
2015-11-22;         47;Sony Ericsson                                     ;Smarthphones y Masivos;                1;           0;                 0;               0;           1;S.C.                ;S.C.                ;           0;           0;          7;Terminales                                        ;SON X10 Mini Pro                                  
2015-11-22;         47;Sony Ericsson                                     ;Smarthphones y Masivos;                0;           1;                 0;               1;           1;S.C.                ;S.C.                ;           0;           0;          7;Terminales                                        ;SON X8                                            
2015-11-22;         47;Sony Ericsson                                     ;Smarthphones y Masivos;              652;        1128;                18;            1146;        1798;64,2                ;100,7               ;           6;         125;          7;Terminales                                        ;SON XP C3                                         
2015-11-22;         47;Sony Ericsson                                     ;Smarthphones y Masivos;                6;          60;                 0;              60;          66;S.C.                ;S.C.                ;           0;           0;          7;Terminales                                        ;SON XP E                                          
2015-11-22;         47;Sony Ericsson                                     ;Smarthphones y Masivos;              495;         718;                 2;             720;        1215;1680,0              ;2835,0              ;           0;           3;          7;Terminales                                        ;SON XP E1                                         
2015-11-22;         47;Sony Ericsson                                     ;Smarthphones y Masivos;             1396;          15;                 0;              15;        1411;52,5                ;4938,5              ;           0;           2;          7;Terminales                                        ;SON XP E4                                         
2015-11-22;         47;Sony Ericsson                                     ;Smarthphones y Masivos;             8321;        2263;                31;            2294;       10615;70,1                ;324,5               ;           1;         229;          7;Terminales                                        ;SON XP E4G                                        
2015-11-22;         47;Sony Ericsson                                     ;Smarthphones y Masivos;               35;          80;                 2;              82;         117;574,0               ;819,0               ;           0;           1;          7;Terminales                                        ;SON XP L                                          
2015-11-22;         47;Sony Ericsson                                     ;Smarthphones y Masivos;               56;         181;                 0;             181;         237;63,4                ;83,0                ;           0;          20;          7;Terminales                                        ;SON XP M2                                         
2015-11-22;         47;Sony Ericsson                                     ;Smarthphones y Masivos;             8309;         545;               162;             707;        9016;78,6                ;1001,8              ;           1;          63;          7;Terminales                                        ;SON XP M4                                         
2015-11-22;         47;Sony Ericsson                                     ;Smarthphones y Masivos;                0;           1;                 0;               1;           1;S.C.                ;S.C.                ;           0;           0;          7;Terminales                                        ;SON XP Pro                                        
2015-11-22;         47;Sony Ericsson                                     ;Smarthphones y Masivos;                0;           6;                 0;               6;           6;S.C.                ;S.C.                ;           0;           0;          7;Terminales                                        ;SON XP U                                          
2015-11-22;         47;Sony Ericsson                                     ;Smarthphones y Masivos;              184;          35;                 1;              36;         220;50,4                ;308,0               ;           0;           5;          7;Terminales                                        ;SON XP ZR                                         
2015-11-23;         48;Sony Ericsson                                     ;iPhone y Premium      ;               20;          27;                 1;              28;          48;28,0                ;48,0                ;           1;           1;          1;Terminales                                        ;SON XP Z1                                         
2015-11-23;         48;Sony Ericsson                                     ;iPhone y Premium      ;               26;          12;                 1;              13;          39;S.C.                ;S.C.                ;           0;           0;          1;Terminales                                        ;SON XP Z3                                         
2015-11-23;         48;Sony Ericsson                                     ;iPhone y Premium      ;                0;           0;                 1;               1;           1;S.C.                ;S.C.                ;           0;           0;          1;Terminales                                        ;SON XP ZL                                         
2015-11-23;         48;Sony Ericsson                                     ;Smarthphones y Masivos;                1;           0;                 0;               0;           1;S.C.                ;S.C.                ;           0;           0;          1;Terminales                                        ;SON K200                                          
2015-11-23;         48;Sony Ericsson                                     ;Smarthphones y Masivos;                0;           1;                 0;               1;           1;S.C.                ;S.C.                ;           0;           0;          1;Terminales                                        ;SON Mugua                                         
2015-11-23;         48;Sony Ericsson                                     ;Smarthphones y Masivos;                0;           1;                 0;               1;           1;S.C.                ;S.C.                ;           0;           0;          1;Terminales                                        ;SON TXT PRO                                       
2015-11-23;         48;Sony Ericsson                                     ;Smarthphones y Masivos;                1;           0;                 0;               0;           1;S.C.                ;S.C.                ;           0;           0;          1;Terminales                                        ;SON W150                                          
2015-11-23;         48;Sony Ericsson                                     ;Smarthphones y Masivos;                1;           0;                 0;               0;           1;S.C.                ;S.C.                ;           0;           0;          1;Terminales                                        ;SON W580                                          
2015-11-23;         48;Sony Ericsson                                     ;Smarthphones y Masivos;                1;           0;                 0;               0;           1;S.C.                ;S.C.                ;           0;           0;          1;Terminales                                        ;SON X10 Mini Pro                                  
2015-11-23;         48;Sony Ericsson                                     ;Smarthphones y Masivos;                0;           1;                 0;               1;           1;S.C.                ;S.C.                ;           0;           0;          1;Terminales                                        ;SON X8                                            
2015-11-23;         48;Sony Ericsson                                     ;Smarthphones y Masivos;              663;        1110;                18;            1128;        1791;35,3                ;56,0                ;          32;          32;          1;Terminales                                        ;SON XP C3                                         
2015-11-23;         48;Sony Ericsson                                     ;Smarthphones y Masivos;                6;          59;                 0;              59;          65;S.C.                ;S.C.                ;           0;           0;          1;Terminales                                        ;SON XP E                                          
2015-11-23;         48;Sony Ericsson                                     ;Smarthphones y Masivos;              549;         718;                 2;             720;        1269;S.C.                ;S.C.                ;           0;           0;          1;Terminales                                        ;SON XP E1                                         
2015-11-23;         48;Sony Ericsson                                     ;Smarthphones y Masivos;             1396;          15;                 0;              15;        1411;S.C.                ;S.C.                ;           0;           0;          1;Terminales                                        ;SON XP E4                                         
2015-11-23;         48;Sony Ericsson                                     ;Smarthphones y Masivos;             8185;        2267;               109;            2376;       10561;108,0               ;480,0               ;          22;          22;          1;Terminales                                        ;SON XP E4G                                        
2015-11-23;         48;Sony Ericsson                                     ;Smarthphones y Masivos;               35;          80;                 2;              82;         117;S.C.                ;S.C.                ;           0;           0;          1;Terminales                                        ;SON XP L                                          
2015-11-23;         48;Sony Ericsson                                     ;Smarthphones y Masivos;               57;         180;                 0;             180;         237;180,0               ;237,0               ;           1;           1;          1;Terminales                                        ;SON XP M2                                         
2015-11-23;         48;Sony Ericsson                                     ;Smarthphones y Masivos;             5772;         527;              2636;            3163;        8935;197,7               ;558,4               ;          16;          16;          1;Terminales                                        ;SON XP M4                                         
2015-11-23;         48;Sony Ericsson                                     ;Smarthphones y Masivos;                0;           1;                 0;               1;           1;S.C.                ;S.C.                ;           0;           0;          1;Terminales                                        ;SON XP Pro                                        
2015-11-23;         48;Sony Ericsson                                     ;Smarthphones y Masivos;                0;           6;                 0;               6;           6;S.C.                ;S.C.                ;           0;           0;          1;Terminales                                        ;SON XP U                                          
2015-11-23;         48;Sony Ericsson                                     ;Smarthphones y Masivos;              174;          32;                 1;              33;         207;11,0                ;69,0                ;           3;           3;          1;Terminales                                        ;SON XP ZR                                         
2015-11-24;         48;Sony Ericsson                                     ;iPhone y Premium      ;               20;          26;                 1;              27;          47;27,0                ;47,0                ;           1;           2;          2;Terminales                                        ;SON XP Z1                                         
2015-11-24;         48;Sony Ericsson                                     ;iPhone y Premium      ;               26;          12;                 1;              13;          39;S.C.                ;S.C.                ;           0;           0;          2;Terminales                                        ;SON XP Z3                                         
2015-11-24;         48;Sony Ericsson                                     ;iPhone y Premium      ;                0;           0;                 1;               1;           1;S.C.                ;S.C.                ;           0;           0;          2;Terminales                                        ;SON XP ZL                                         
2015-11-24;         48;Sony Ericsson                                     ;Smarthphones y Masivos;                1;           0;                 0;               0;           1;S.C.                ;S.C.                ;           0;           0;          2;Terminales                                        ;SON K200                                          
2015-11-24;         48;Sony Ericsson                                     ;Smarthphones y Masivos;                0;           1;                 0;               1;           1;S.C.                ;S.C.                ;           0;           0;          2;Terminales                                        ;SON Mugua                                         
2015-11-24;         48;Sony Ericsson                                     ;Smarthphones y Masivos;                0;           1;                 0;               1;           1;S.C.                ;S.C.                ;           0;           0;          2;Terminales                                        ;SON TXT PRO                                       
2015-11-24;         48;Sony Ericsson                                     ;Smarthphones y Masivos;                1;           0;                 0;               0;           1;S.C.                ;S.C.                ;           0;           0;          2;Terminales                                        ;SON W150                                          
2015-11-24;         48;Sony Ericsson                                     ;Smarthphones y Masivos;                1;           0;                 0;               0;           1;S.C.                ;S.C.                ;           0;           0;          2;Terminales                                        ;SON W580                                          
2015-11-24;         48;Sony Ericsson                                     ;Smarthphones y Masivos;                1;           0;                 0;               0;           1;S.C.                ;S.C.                ;           0;           0;          2;Terminales                                        ;SON X10 Mini Pro                                  
2015-11-24;         48;Sony Ericsson                                     ;Smarthphones y Masivos;                0;           1;                 0;               1;           1;S.C.                ;S.C.                ;           0;           0;          2;Terminales                                        ;SON X8                                            
2015-11-24;         48;Sony Ericsson                                     ;Smarthphones y Masivos;              663;        1103;                18;            1121;        1784;42,3                ;67,3                ;          21;          53;          2;Terminales                                        ;SON XP C3                                         
2015-11-24;         48;Sony Ericsson                                     ;Smarthphones y Masivos;                6;          59;                 0;              59;          65;S.C.                ;S.C.                ;           0;           0;          2;Terminales                                        ;SON XP E                                          
2015-11-24;         48;Sony Ericsson                                     ;Smarthphones y Masivos;              549;         711;                 2;             713;        1262;S.C.                ;S.C.                ;           0;           0;          2;Terminales                                        ;SON XP E1                                         
2015-11-24;         48;Sony Ericsson                                     ;Smarthphones y Masivos;             1396;          15;                 0;              15;        1411;S.C.                ;S.C.                ;           0;           0;          2;Terminales                                        ;SON XP E4                                         
2015-11-24;         48;Sony Ericsson                                     ;Smarthphones y Masivos;             7082;        2320;               114;            2434;        9516;95,5                ;373,2               ;          29;          51;          2;Terminales                                        ;SON XP E4G                                        
2015-11-24;         48;Sony Ericsson                                     ;Smarthphones y Masivos;               35;          80;                 2;              82;         117;S.C.                ;S.C.                ;           0;           0;          2;Terminales                                        ;SON XP L                                          
2015-11-24;         48;Sony Ericsson                                     ;Smarthphones y Masivos;               57;         174;                 0;             174;         231;49,7                ;66,0                ;           6;           7;          2;Terminales                                        ;SON XP M2                                         
2015-11-24;         48;Sony Ericsson                                     ;Smarthphones y Masivos;             5437;        1458;              1998;            3456;        8893;164,6               ;423,5               ;          26;          42;          2;Terminales                                        ;SON XP M4                                         
2015-11-24;         48;Sony Ericsson                                     ;Smarthphones y Masivos;             3800;           0;                 0;               0;        3800;S.C.                ;S.C.                ;           0;           0;          2;Terminales                                        ;SON XP M5                                         
2015-11-24;         48;Sony Ericsson                                     ;Smarthphones y Masivos;                0;           1;                 0;               1;           1;S.C.                ;S.C.                ;           0;           0;          2;Terminales                                        ;SON XP Pro                                        
2015-11-24;         48;Sony Ericsson                                     ;Smarthphones y Masivos;                0;           6;                 0;               6;           6;S.C.                ;S.C.                ;           0;           0;          2;Terminales                                        ;SON XP U                                          
2015-11-24;         48;Sony Ericsson                                     ;Smarthphones y Masivos;              174;          31;                 1;              32;         206;16,0                ;103,0               ;           1;           4;          2;Terminales                                        ;SON XP ZR                                         
2015-11-25;         48;Sony Ericsson                                     ;iPhone y Premium      ;               20;          27;                 0;              27;          47;40,5                ;70,5                ;           0;           2;          3;Terminales                                        ;SON XP Z1                                         
2015-11-25;         48;Sony Ericsson                                     ;iPhone y Premium      ;               26;          12;                 1;              13;          39;S.C.                ;S.C.                ;           0;           0;          3;Terminales                                        ;SON XP Z3                                         
2015-11-25;         48;Sony Ericsson                                     ;iPhone y Premium      ;                0;           0;                 1;               1;           1;S.C.                ;S.C.                ;           0;           0;          3;Terminales                                        ;SON XP ZL                                         
2015-11-25;         48;Sony Ericsson                                     ;Smarthphones y Masivos;                1;           0;                 0;               0;           1;S.C.                ;S.C.                ;           0;           0;          3;Terminales                                        ;SON K200                                          
2015-11-25;         48;Sony Ericsson                                     ;Smarthphones y Masivos;                0;           1;                 0;               1;           1;S.C.                ;S.C.                ;           0;           0;          3;Terminales                                        ;SON Mugua                                         
2015-11-25;         48;Sony Ericsson                                     ;Smarthphones y Masivos;                0;           1;                 0;               1;           1;S.C.                ;S.C.                ;           0;           0;          3;Terminales                                        ;SON TXT PRO                                       
2015-11-25;         48;Sony Ericsson                                     ;Smarthphones y Masivos;                1;           0;                 0;               0;           1;S.C.                ;S.C.                ;           0;           0;          3;Terminales                                        ;SON W150                                          
2015-11-25;         48;Sony Ericsson                                     ;Smarthphones y Masivos;                1;           0;                 0;               0;           1;S.C.                ;S.C.                ;           0;           0;          3;Terminales                                        ;SON W580                                          
2015-11-25;         48;Sony Ericsson                                     ;Smarthphones y Masivos;                1;           0;                 0;               0;           1;S.C.                ;S.C.                ;           0;           0;          3;Terminales                                        ;SON X10 Mini Pro                                  
2015-11-25;         48;Sony Ericsson                                     ;Smarthphones y Masivos;                0;           1;                 0;               1;           1;S.C.                ;S.C.                ;           0;           0;          3;Terminales                                        ;SON X8                                            
2015-11-25;         48;Sony Ericsson                                     ;Smarthphones y Masivos;              663;        1097;                 4;            1101;        1764;40,3                ;64,5                ;          29;          82;          3;Terminales                                        ;SON XP C3                                         
2015-11-25;         48;Sony Ericsson                                     ;Smarthphones y Masivos;                6;          59;                 0;              59;          65;S.C.                ;S.C.                ;           0;           0;          3;Terminales                                        ;SON XP E                                          
2015-11-25;         48;Sony Ericsson                                     ;Smarthphones y Masivos;              545;         709;                 2;             711;        1256;711,0               ;1256,0              ;           3;           3;          3;Terminales                                        ;SON XP E1                                         
2015-11-25;         48;Sony Ericsson                                     ;Smarthphones y Masivos;             1396;          15;                 0;              15;        1411;S.C.                ;S.C.                ;           0;           0;          3;Terminales                                        ;SON XP E4                                         
2015-11-25;         48;Sony Ericsson                                     ;Smarthphones y Masivos;             6500;        2268;               152;            2420;        8920;78,1                ;287,7               ;          42;          93;          3;Terminales                                        ;SON XP E4G                                        
2015-11-25;         48;Sony Ericsson                                     ;Smarthphones y Masivos;               35;          81;                 1;              82;         117;S.C.                ;S.C.                ;           0;           0;          3;Terminales                                        ;SON XP L                                          
2015-11-25;         48;Sony Ericsson                                     ;Smarthphones y Masivos;               57;         173;                 0;             173;         230;64,9                ;86,3                ;           1;           8;          3;Terminales                                        ;SON XP M2                                         
2015-11-25;         48;Sony Ericsson                                     ;Smarthphones y Masivos;             5435;        2894;               533;            3427;        8862;140,8               ;364,2               ;          31;          73;          3;Terminales                                        ;SON XP M4                                         
2015-11-25;         48;Sony Ericsson                                     ;Smarthphones y Masivos;             3800;           0;                 0;               0;        3800;S.C.                ;S.C.                ;           0;           0;          3;Terminales                                        ;SON XP M5                                         
2015-11-25;         48;Sony Ericsson                                     ;Smarthphones y Masivos;                0;           1;                 0;               1;           1;S.C.                ;S.C.                ;           0;           0;          3;Terminales                                        ;SON XP Pro                                        
2015-11-25;         48;Sony Ericsson                                     ;Smarthphones y Masivos;                0;           6;                 0;               6;           6;S.C.                ;S.C.                ;           0;           0;          3;Terminales                                        ;SON XP U                                          
2015-11-25;         48;Sony Ericsson                                     ;Smarthphones y Masivos;              174;          31;                 1;              32;         206;24,0                ;154,5               ;           0;           4;          3;Terminales                                        ;SON XP ZR                                         
2015-11-26;         48;Sony Ericsson                                     ;iPhone y Premium      ;               20;          27;                 0;              27;          47;54,0                ;94,0                ;           0;           2;          4;Terminales                                        ;SON XP Z1                                         
2015-11-26;         48;Sony Ericsson                                     ;iPhone y Premium      ;               23;          12;                 3;              15;          38;60,0                ;152,0               ;           1;           1;          4;Terminales                                        ;SON XP Z3                                         
2015-11-26;         48;Sony Ericsson                                     ;iPhone y Premium      ;                0;           0;                 1;               1;           1;S.C.                ;S.C.                ;           0;           0;          4;Terminales                                        ;SON XP ZL                                         
2015-11-26;         48;Sony Ericsson                                     ;Smarthphones y Masivos;                1;           0;                 0;               0;           1;S.C.                ;S.C.                ;           0;           0;          4;Terminales                                        ;SON K200                                          
2015-11-26;         48;Sony Ericsson                                     ;Smarthphones y Masivos;                0;           1;                 0;               1;           1;S.C.                ;S.C.                ;           0;           0;          4;Terminales                                        ;SON Mugua                                         
2015-11-26;         48;Sony Ericsson                                     ;Smarthphones y Masivos;                0;           1;                 0;               1;           1;S.C.                ;S.C.                ;           0;           0;          4;Terminales                                        ;SON TXT PRO                                       
2015-11-26;         48;Sony Ericsson                                     ;Smarthphones y Masivos;                1;           0;                 0;               0;           1;S.C.                ;S.C.                ;           0;           0;          4;Terminales                                        ;SON W150                                          
2015-11-26;         48;Sony Ericsson                                     ;Smarthphones y Masivos;                1;           0;                 0;               0;           1;S.C.                ;S.C.                ;           0;           0;          4;Terminales                                        ;SON W580                                          
2015-11-26;         48;Sony Ericsson                                     ;Smarthphones y Masivos;                1;           0;                 0;               0;           1;S.C.                ;S.C.                ;           0;           0;          4;Terminales                                        ;SON X10 Mini Pro                                  
2015-11-26;         48;Sony Ericsson                                     ;Smarthphones y Masivos;                0;           1;                 0;               1;           1;S.C.                ;S.C.                ;           0;           0;          4;Terminales                                        ;SON X8                                            
2015-11-26;         48;Sony Ericsson                                     ;Smarthphones y Masivos;              663;        1101;                 4;            1105;        1768;44,6                ;71,4                ;          17;          99;          4;Terminales                                        ;SON XP C3                                         
2015-11-26;         48;Sony Ericsson                                     ;Smarthphones y Masivos;                6;          59;                 0;              59;          65;S.C.                ;S.C.                ;           0;           0;          4;Terminales                                        ;SON XP E                                          
2015-11-26;         48;Sony Ericsson                                     ;Smarthphones y Masivos;              545;         706;                 1;             707;        1252;353,5               ;626,0               ;           5;           8;          4;Terminales                                        ;SON XP E1                                         
2015-11-26;         48;Sony Ericsson                                     ;Smarthphones y Masivos;             1396;          15;                 0;              15;        1411;S.C.                ;S.C.                ;           0;           0;          4;Terminales                                        ;SON XP E4                                         
2015-11-26;         48;Sony Ericsson                                     ;Smarthphones y Masivos;             4984;        2273;               147;            2420;        7404;82,7                ;253,1               ;          24;         117;          4;Terminales                                        ;SON XP E4G                                        
2015-11-26;         48;Sony Ericsson                                     ;Smarthphones y Masivos;               35;          82;                 1;              83;         118;S.C.                ;S.C.                ;           0;           0;          4;Terminales                                        ;SON XP L                                          
2015-11-26;         48;Sony Ericsson                                     ;Smarthphones y Masivos;               57;         174;                 0;             174;         231;99,4                ;132,0               ;          -1;           7;          4;Terminales                                        ;SON XP M2                                         
2015-11-26;         48;Sony Ericsson                                     ;Smarthphones y Masivos;             5440;        3224;               154;            3378;        8818;121,7               ;317,8               ;          38;         111;          4;Terminales                                        ;SON XP M4                                         
2015-11-26;         48;Sony Ericsson                                     ;Smarthphones y Masivos;             3800;           0;                 0;               0;        3800;S.C.                ;S.C.                ;           0;           0;          4;Terminales                                        ;SON XP M5                                         
2015-11-26;         48;Sony Ericsson                                     ;Smarthphones y Masivos;                0;           1;                 0;               1;           1;S.C.                ;S.C.                ;           0;           0;          4;Terminales                                        ;SON XP Pro                                        
2015-11-26;         48;Sony Ericsson                                     ;Smarthphones y Masivos;                0;           6;                 0;               6;           6;S.C.                ;S.C.                ;           0;           0;          4;Terminales                                        ;SON XP U                                          
2015-11-26;         48;Sony Ericsson                                     ;Smarthphones y Masivos;               78;          30;                 0;              30;         108;20,0                ;72,0                ;           2;           6;          4;Terminales                                        ;SON XP ZR                                         
2015-11-27;         48;Sony Ericsson                                     ;iPhone y Premium      ;                0;           0;                 0;               0;           0;0,0                 ;0,0                 ;           0;           2;          5;Terminales                                        ;SON XP Z1                                         
2015-11-27;         48;Sony Ericsson                                     ;iPhone y Premium      ;                0;           0;                 0;               0;           0;0,0                 ;0,0                 ;           0;           1;          5;Terminales                                        ;SON XP Z3                                         
2015-11-27;         48;Sony Ericsson                                     ;Smarthphones y Masivos;                0;           0;                 0;               0;           0;0,0                 ;0,0                 ;          23;         122;          5;Terminales                                        ;SON XP C3                                         
2015-11-27;         48;Sony Ericsson                                     ;Smarthphones y Masivos;                0;           0;                 0;               0;           0;0,0                 ;0,0                 ;           2;          10;          5;Terminales                                        ;SON XP E1                                         
2015-11-27;         48;Sony Ericsson                                     ;Smarthphones y Masivos;                0;           0;                 0;               0;           0;0,0                 ;0,0                 ;          32;         149;          5;Terminales                                        ;SON XP E4G                                        
2015-11-27;         48;Sony Ericsson                                     ;Smarthphones y Masivos;                0;           0;                 0;               0;           0;0,0                 ;0,0                 ;           1;           1;          5;Terminales                                        ;SON XP L                                          
2015-11-27;         48;Sony Ericsson                                     ;Smarthphones y Masivos;                0;           0;                 0;               0;           0;0,0                 ;0,0                 ;           4;          11;          5;Terminales                                        ;SON XP M2                                         
2015-11-27;         48;Sony Ericsson                                     ;Smarthphones y Masivos;                0;           0;                 0;               0;           0;0,0                 ;0,0                 ;          37;         148;          5;Terminales                                        ;SON XP M4                                         
2015-11-27;         48;Sony Ericsson                                     ;Smarthphones y Masivos;                0;           0;                 0;               0;           0;0,0                 ;0,0                 ;           1;           7;          5;Terminales                                        ;SON XP ZR                                         
2015-11-28;         48;Sony Ericsson                                     ;iPhone y Premium      ;                0;           0;                 0;               0;           0;0,0                 ;0,0                 ;           0;           2;          6;Terminales                                        ;SON XP Z1                                         
2015-11-28;         48;Sony Ericsson                                     ;iPhone y Premium      ;                0;           0;                 0;               0;           0;0,0                 ;0,0                 ;           0;           1;          6;Terminales                                        ;SON XP Z3                                         
2015-11-28;         48;Sony Ericsson                                     ;Smarthphones y Masivos;                0;           0;                 0;               0;           0;0,0                 ;0,0                 ;          23;         145;          6;Terminales                                        ;SON XP C3                                         
2015-11-28;         48;Sony Ericsson                                     ;Smarthphones y Masivos;                0;           0;                 0;               0;           0;0,0                 ;0,0                 ;           4;          14;          6;Terminales                                        ;SON XP E1                                         
2015-11-28;         48;Sony Ericsson                                     ;Smarthphones y Masivos;                0;           0;                 0;               0;           0;0,0                 ;0,0                 ;           2;           2;          6;Terminales                                        ;SON XP E4                                         
2015-11-28;         48;Sony Ericsson                                     ;Smarthphones y Masivos;                0;           0;                 0;               0;           0;0,0                 ;0,0                 ;           6;         155;          6;Terminales                                        ;SON XP E4G                                        
2015-11-28;         48;Sony Ericsson                                     ;Smarthphones y Masivos;                0;           0;                 0;               0;           0;0,0                 ;0,0                 ;           0;           1;          6;Terminales                                        ;SON XP L                                          
2015-11-28;         48;Sony Ericsson                                     ;Smarthphones y Masivos;                0;           0;                 0;               0;           0;0,0                 ;0,0                 ;           0;          11;          6;Terminales                                        ;SON XP M2                                         
2015-11-28;         48;Sony Ericsson                                     ;Smarthphones y Masivos;                0;           0;                 0;               0;           0;0,0                 ;0,0                 ;          14;         162;          6;Terminales                                        ;SON XP M4                                         
2015-11-28;         48;Sony Ericsson                                     ;Smarthphones y Masivos;                0;           0;                 0;               0;           0;0,0                 ;0,0                 ;           0;           7;          6;Terminales                                        ;SON XP ZR                                         
2015-11-29;         48;Sony Ericsson                                     ;iPhone y Premium      ;               20;          27;                 0;              27;          47;94,5                ;164,5               ;           0;           2;          7;Terminales                                        ;SON XP Z1                                         
2015-11-29;         48;Sony Ericsson                                     ;iPhone y Premium      ;               26;          12;                 3;              15;          41;105,0               ;287,0               ;           0;           1;          7;Terminales                                        ;SON XP Z3                                         
2015-11-29;         48;Sony Ericsson                                     ;iPhone y Premium      ;                0;           0;                 1;               1;           1;S.C.                ;S.C.                ;           0;           0;          7;Terminales                                        ;SON XP ZL                                         
2015-11-29;         48;Sony Ericsson                                     ;Smarthphones y Masivos;                1;           0;                 0;               0;           1;S.C.                ;S.C.                ;           0;           0;          7;Terminales                                        ;SON K200                                          
2015-11-29;         48;Sony Ericsson                                     ;Smarthphones y Masivos;                0;           1;                 0;               1;           1;S.C.                ;S.C.                ;           0;           0;          7;Terminales                                        ;SON Mugua                                         
2015-11-29;         48;Sony Ericsson                                     ;Smarthphones y Masivos;                0;           1;                 0;               1;           1;S.C.                ;S.C.                ;           0;           0;          7;Terminales                                        ;SON TXT PRO                                       
2015-11-29;         48;Sony Ericsson                                     ;Smarthphones y Masivos;                1;           0;                 0;               0;           1;S.C.                ;S.C.                ;           0;           0;          7;Terminales                                        ;SON W150                                          
2015-11-29;         48;Sony Ericsson                                     ;Smarthphones y Masivos;                1;           0;                 0;               0;           1;S.C.                ;S.C.                ;           0;           0;          7;Terminales                                        ;SON W580                                          
2015-11-29;         48;Sony Ericsson                                     ;Smarthphones y Masivos;                1;           0;                 0;               0;           1;S.C.                ;S.C.                ;           0;           0;          7;Terminales                                        ;SON X10 Mini Pro                                  
2015-11-29;         48;Sony Ericsson                                     ;Smarthphones y Masivos;                0;           1;                 0;               1;           1;S.C.                ;S.C.                ;           0;           0;          7;Terminales                                        ;SON X8                                            
2015-11-29;         48;Sony Ericsson                                     ;Smarthphones y Masivos;              663;        1084;                 3;            1087;        1750;49,7                ;80,1                ;           8;         153;          7;Terminales                                        ;SON XP C3                                         
2015-11-29;         48;Sony Ericsson                                     ;Smarthphones y Masivos;                7;          58;                 0;              58;          65;S.C.                ;S.C.                ;           0;           0;          7;Terminales                                        ;SON XP E                                          
2015-11-29;         48;Sony Ericsson                                     ;Smarthphones y Masivos;              548;         699;                 1;             700;        1248;326,7               ;582,4               ;           1;          15;          7;Terminales                                        ;SON XP E1                                         
2015-11-29;         48;Sony Ericsson                                     ;Smarthphones y Masivos;             1396;          15;                 0;              15;        1411;52,5                ;4938,5              ;           0;           2;          7;Terminales                                        ;SON XP E4                                         
2015-11-29;         48;Sony Ericsson                                     ;Smarthphones y Masivos;             4992;        2228;               171;            2399;        7391;107,6               ;331,6               ;           1;         156;          7;Terminales                                        ;SON XP E4G                                        
2015-11-29;         48;Sony Ericsson                                     ;Smarthphones y Masivos;               36;          80;                 0;              80;         116;560,0               ;812,0               ;           0;           1;          7;Terminales                                        ;SON XP L                                          
2015-11-29;         48;Sony Ericsson                                     ;Smarthphones y Masivos;               59;         170;                 0;             170;         229;108,2               ;145,7               ;           0;          11;          7;Terminales                                        ;SON XP M2                                         
2015-11-29;         48;Sony Ericsson                                     ;Smarthphones y Masivos;             5373;        3265;               127;            3392;        8765;145,7               ;376,4               ;           1;         163;          7;Terminales                                        ;SON XP M4                                         
2015-11-29;         48;Sony Ericsson                                     ;Smarthphones y Masivos;             3600;           0;                 0;               0;        3600;S.C.                ;S.C.                ;           0;           0;          7;Terminales                                        ;SON XP M5                                         
2015-11-29;         48;Sony Ericsson                                     ;Smarthphones y Masivos;                0;           1;                 0;               1;           1;S.C.                ;S.C.                ;           0;           0;          7;Terminales                                        ;SON XP Pro                                        
2015-11-29;         48;Sony Ericsson                                     ;Smarthphones y Masivos;                0;           6;                 0;               6;           6;S.C.                ;S.C.                ;           0;           0;          7;Terminales                                        ;SON XP U                                          
2015-11-29;         48;Sony Ericsson                                     ;Smarthphones y Masivos;               78;          28;                 0;              28;         106;28,0                ;106,0               ;           0;           7;          7;Terminales                                        ;SON XP ZR                                         
2015-11-30;         49;Sony Ericsson                                     ;iPhone y Premium      ;               20;          22;                 0;              22;          42;S.C.                ;S.C.                ;           0;           0;          1;Terminales                                        ;SON XP Z1                                         
2015-11-30;         49;Sony Ericsson                                     ;iPhone y Premium      ;               26;          15;                 0;              15;          41;S.C.                ;S.C.                ;           0;           0;          1;Terminales                                        ;SON XP Z3                                         
2015-11-30;         49;Sony Ericsson                                     ;iPhone y Premium      ;                0;           0;                 1;               1;           1;S.C.                ;S.C.                ;           0;           0;          1;Terminales                                        ;SON XP ZL                                         
2015-11-30;         49;Sony Ericsson                                     ;Smarthphones y Masivos;                1;           0;                 0;               0;           1;S.C.                ;S.C.                ;           0;           0;          1;Terminales                                        ;SON K200                                          
2015-11-30;         49;Sony Ericsson                                     ;Smarthphones y Masivos;                0;           1;                 0;               1;           1;S.C.                ;S.C.                ;           0;           0;          1;Terminales                                        ;SON Mugua                                         
2015-11-30;         49;Sony Ericsson                                     ;Smarthphones y Masivos;                0;           1;                 0;               1;           1;S.C.                ;S.C.                ;           0;           0;          1;Terminales                                        ;SON TXT PRO                                       
2015-11-30;         49;Sony Ericsson                                     ;Smarthphones y Masivos;                1;           0;                 0;               0;           1;S.C.                ;S.C.                ;           0;           0;          1;Terminales                                        ;SON W150                                          
2015-11-30;         49;Sony Ericsson                                     ;Smarthphones y Masivos;                1;           0;                 0;               0;           1;S.C.                ;S.C.                ;           0;           0;          1;Terminales                                        ;SON W580                                          
2015-11-30;         49;Sony Ericsson                                     ;Smarthphones y Masivos;                1;           0;                 0;               0;           1;S.C.                ;S.C.                ;           0;           0;          1;Terminales                                        ;SON X10 Mini Pro                                  
2015-11-30;         49;Sony Ericsson                                     ;Smarthphones y Masivos;                0;           1;                 0;               1;           1;S.C.                ;S.C.                ;           0;           0;          1;Terminales                                        ;SON X8                                            
2015-11-30;         49;Sony Ericsson                                     ;Smarthphones y Masivos;              663;        1074;                 5;            1079;        1742;54,0                ;87,1                ;          20;          20;          1;Terminales                                        ;SON XP C3                                         
2015-11-30;         49;Sony Ericsson                                     ;Smarthphones y Masivos;                7;          58;                 0;              58;          65;S.C.                ;S.C.                ;           0;           0;          1;Terminales                                        ;SON XP E                                          
2015-11-30;         49;Sony Ericsson                                     ;Smarthphones y Masivos;              548;         683;                 1;             684;        1232;114,0               ;205,3               ;           6;           6;          1;Terminales                                        ;SON XP E1                                         
2015-11-30;         49;Sony Ericsson                                     ;Smarthphones y Masivos;             1396;          15;                 0;              15;        1411;S.C.                ;S.C.                ;           0;           0;          1;Terminales                                        ;SON XP E4                                         
2015-11-30;         49;Sony Ericsson                                     ;Smarthphones y Masivos;             4944;        2327;                96;            2423;        7367;161,5               ;491,1               ;          15;          15;          1;Terminales                                        ;SON XP E4G                                        
2015-11-30;         49;Sony Ericsson                                     ;Smarthphones y Masivos;               36;          44;                 0;              44;          80;S.C.                ;S.C.                ;           0;           0;          1;Terminales                                        ;SON XP L                                          
2015-11-30;         49;Sony Ericsson                                     ;Smarthphones y Masivos;               59;         168;                 0;             168;         227;84,0                ;113,5               ;           2;           2;          1;Terminales                                        ;SON XP M2                                         
2015-11-30;         49;Sony Ericsson                                     ;Smarthphones y Masivos;             5334;        3243;               127;            3370;        8704;71,7                ;185,2               ;          47;          47;          1;Terminales                                        ;SON XP M4                                         
2015-11-30;         49;Sony Ericsson                                     ;Smarthphones y Masivos;             3600;           0;                 0;               0;        3600;S.C.                ;S.C.                ;           0;           0;          1;Terminales                                        ;SON XP M5                                         
2015-11-30;         49;Sony Ericsson                                     ;Smarthphones y Masivos;                0;           1;                 0;               1;           1;S.C.                ;S.C.                ;           0;           0;          1;Terminales                                        ;SON XP Pro                                        
2015-11-30;         49;Sony Ericsson                                     ;Smarthphones y Masivos;                0;           6;                 0;               6;           6;S.C.                ;S.C.                ;           0;           0;          1;Terminales                                        ;SON XP U                                          
2015-11-30;         49;Sony Ericsson                                     ;Smarthphones y Masivos;               78;          29;                 0;              29;         107;S.C.                ;S.C.                ;           0;           0;          1;Terminales                                        ;SON XP ZR                                         
2015-11-16;         47;ZTE                                               ;Smarthphones y Masivos;            10647;          25;                 0;              25;       10672;S.C.                ;S.C.                ;           0;           0;          1;Terminales                                        ;ZTE Blade X3                                      
2015-11-16;         47;ZTE                                               ;Smarthphones y Masivos;               62;           0;                 0;               0;          62;S.C.                ;S.C.                ;           0;           0;          1;Terminales                                        ;ZTE Kis 2                                         
2015-11-16;         47;ZTE                                               ;Smarthphones y Masivos;                0;           5;                 0;               5;           5;S.C.                ;S.C.                ;           0;           0;          1;Terminales                                        ;ZTE V857                                          
2015-11-17;         47;ZTE                                               ;Smarthphones y Masivos;            10627;          25;                20;              45;       10672;S.C.                ;S.C.                ;           0;           0;          2;Terminales                                        ;ZTE Blade X3                                      
2015-11-17;         47;ZTE                                               ;Smarthphones y Masivos;               62;           0;                 0;               0;          62;S.C.                ;S.C.                ;           0;           0;          2;Terminales                                        ;ZTE Kis 2                                         
2015-11-17;         47;ZTE                                               ;Smarthphones y Masivos;                0;           5;                 0;               5;           5;S.C.                ;S.C.                ;           0;           0;          2;Terminales                                        ;ZTE V857                                          
2015-11-18;         47;ZTE                                               ;Smarthphones y Masivos;            10627;          25;                20;              45;       10672;S.C.                ;S.C.                ;           0;           0;          3;Terminales                                        ;ZTE Blade X3                                      
2015-11-18;         47;ZTE                                               ;Smarthphones y Masivos;               62;           0;                 0;               0;          62;S.C.                ;S.C.                ;           0;           0;          3;Terminales                                        ;ZTE Kis 2                                         
2015-11-18;         47;ZTE                                               ;Smarthphones y Masivos;                0;           5;                 0;               5;           5;S.C.                ;S.C.                ;           0;           0;          3;Terminales                                        ;ZTE V857                                          
2015-11-19;         47;ZTE                                               ;Smarthphones y Masivos;            10427;          25;                20;              45;       10472;S.C.                ;S.C.                ;           0;           0;          4;Terminales                                        ;ZTE Blade X3                                      
2015-11-19;         47;ZTE                                               ;Smarthphones y Masivos;               62;           0;                 0;               0;          62;S.C.                ;S.C.                ;           0;           0;          4;Terminales                                        ;ZTE Kis 2                                         
2015-11-19;         47;ZTE                                               ;Smarthphones y Masivos;                0;           5;                 0;               5;           5;S.C.                ;S.C.                ;           0;           0;          4;Terminales                                        ;ZTE V857                                          
2015-11-22;         47;ZTE                                               ;Smarthphones y Masivos;            10427;          45;                 0;              45;       10472;S.C.                ;S.C.                ;           0;           0;          7;Terminales                                        ;ZTE Blade X3                                      
2015-11-22;         47;ZTE                                               ;Smarthphones y Masivos;               62;           0;                 0;               0;          62;S.C.                ;S.C.                ;           0;           0;          7;Terminales                                        ;ZTE Kis 2                                         
2015-11-22;         47;ZTE                                               ;Smarthphones y Masivos;                0;           5;                 0;               5;           5;S.C.                ;S.C.                ;           0;           0;          7;Terminales                                        ;ZTE V857                                          
2015-11-23;         48;ZTE                                               ;Smarthphones y Masivos;            10157;          45;                20;              65;       10222;65,0                ;10222,0             ;           1;           1;          1;Terminales                                        ;ZTE Blade X3                                      
2015-11-23;         48;ZTE                                               ;Smarthphones y Masivos;               62;           0;                 0;               0;          62;S.C.                ;S.C.                ;           0;           0;          1;Terminales                                        ;ZTE Kis 2                                         
2015-11-23;         48;ZTE                                               ;Smarthphones y Masivos;                0;           5;                 0;               5;           5;S.C.                ;S.C.                ;           0;           0;          1;Terminales                                        ;ZTE V857                                          
2015-11-24;         48;ZTE                                               ;Smarthphones y Masivos;            17877;          45;                20;              65;       17942;130,0               ;35884,0             ;           0;           1;          2;Terminales                                        ;ZTE Blade X3                                      
2015-11-24;         48;ZTE                                               ;Smarthphones y Masivos;               62;           0;                 0;               0;          62;S.C.                ;S.C.                ;           0;           0;          2;Terminales                                        ;ZTE Kis 2                                         
2015-11-24;         48;ZTE                                               ;Smarthphones y Masivos;                0;           5;                 0;               5;           5;S.C.                ;S.C.                ;           0;           0;          2;Terminales                                        ;ZTE V857                                          
2015-11-25;         48;ZTE                                               ;Smarthphones y Masivos;            17877;          64;                 0;              64;       17941;96,0                ;26911,5             ;           1;           2;          3;Terminales                                        ;ZTE Blade X3                                      
2015-11-25;         48;ZTE                                               ;Smarthphones y Masivos;               62;           0;                 0;               0;          62;S.C.                ;S.C.                ;           0;           0;          3;Terminales                                        ;ZTE Kis 2                                         
2015-11-25;         48;ZTE                                               ;Smarthphones y Masivos;                0;           5;                 0;               5;           5;S.C.                ;S.C.                ;           0;           0;          3;Terminales                                        ;ZTE V857                                          
2015-11-26;         48;ZTE                                               ;Smarthphones y Masivos;            17877;          64;                 0;              64;       17941;128,0               ;35882,0             ;           0;           2;          4;Terminales                                        ;ZTE Blade X3                                      
2015-11-26;         48;ZTE                                               ;Smarthphones y Masivos;               62;           0;                 0;               0;          62;S.C.                ;S.C.                ;           0;           0;          4;Terminales                                        ;ZTE Kis 2                                         
2015-11-26;         48;ZTE                                               ;Smarthphones y Masivos;                0;           5;                 0;               5;           5;S.C.                ;S.C.                ;           0;           0;          4;Terminales                                        ;ZTE V857                                          
2015-11-27;         48;ZTE                                               ;Smarthphones y Masivos;                0;           0;                 0;               0;           0;0,0                 ;0,0                 ;           3;           5;          5;Terminales                                        ;ZTE Blade X3                                      
2015-11-28;         48;ZTE                                               ;Smarthphones y Masivos;                0;           0;                 0;               0;           0;0,0                 ;0,0                 ;           0;           5;          6;Terminales                                        ;ZTE Blade X3                                      
2015-11-29;         48;ZTE                                               ;Smarthphones y Masivos;            17877;          61;                 0;              61;       17938;85,4                ;25113,2             ;           0;           5;          7;Terminales                                        ;ZTE Blade X3                                      
2015-11-29;         48;ZTE                                               ;Smarthphones y Masivos;               62;           0;                 0;               0;          62;S.C.                ;S.C.                ;           0;           0;          7;Terminales                                        ;ZTE Kis 2                                         
2015-11-29;         48;ZTE                                               ;Smarthphones y Masivos;                0;           5;                 0;               5;           5;S.C.                ;S.C.                ;           0;           0;          7;Terminales                                        ;ZTE V857                                          
2015-11-30;         49;ZTE                                               ;Smarthphones y Masivos;            18157;          61;                 0;              61;       18218;S.C.                ;S.C.                ;           0;           0;          1;Terminales                                        ;ZTE Blade X3                                      
2015-11-30;         49;ZTE                                               ;Smarthphones y Masivos;               62;           0;                 0;               0;          62;S.C.                ;S.C.                ;           0;           0;          1;Terminales                                        ;ZTE Kis 2                                         
2015-11-30;         49;ZTE                                               ;Smarthphones y Masivos;                0;           5;                 0;               5;           5;S.C.                ;S.C.                ;           0;           0;          1;Terminales                                        ;ZTE V857                                          